CTTACGGCGCTAAACACCGC -> TTACGGCGCTAAACACCGCA
CGCTGTTACCGCTTATAGTG -> GCTGTTACCGCTTATAGTGT
CAAATCGTGGCCTACAAGCT -> AAATCGTGGCCTACAAGCTC
CTTGTGTCTTCAAATGGCTC -> TTGTGTCTTCAAATGGCTCA
ATAGAGTCTAATCCCCGACT -> TAGAGTCTAATCCCCGACTT
GAGGTATTTTCAACCGCACC -> AGGTATTTTCAACCGCACCT
ATAACCAAGAAGCTAGAGAC -> TAACCAAGAAGCTAGAGACG
TGATAACGCGCCAGTGTGGT -> GATAACGCGCCAGTGTGGTT
AGAGGGCCGACAACAAAACC -> GAGGGCCGACAACAAAACCC
AATAACCAAGAAGCTAGAGA -> ATAACCAAGAAGCTAGAGAC
TATTTTCAACCGCACCTGAA -> ATTTTCAACCGCACCTGAAC
GAGGGGTTTGCGAGGTGCAC -> AGGGGTTTGCGAGGTGCACG
CTCCAGAGAGGAAGGTGTAC -> TCCAGAGAGGAAGGTGTACA
GGGATTCTCGATGAATACAC -> GGATTCTCGATGAATACACG
TAAGTAAGTAGTTTCAGGCG -> AAGTAAGTAGTTTCAGGCGA
CCCTTGATAACGCGCCAGTG -> CCTTGATAACGCGCCAGTGT
CGGAATGCGAAGGCGATAAT -> GGAATGCGAAGGCGATAATC
GGCATCCTTTGACGGTGAGC -> GCATCCTTTGACGGTGAGCC
CAGTGTGGTTCACTCGCCAC -> AGTGTGGTTCACTCGCCACG
AATTTCCTGACGCTGGCTGT -> ATTTCCTGACGCTGGCTGTC
TGAGCTGTATCTCGAGGGGT -> GAGCTGTATCTCGAGGGGTT
CTCGCCGAAAGGGGCCTTTA -> TCGCCGAAAGGGGCCTTTAC
GATCATCACTGGTCATTTCT -> ATCATCACTGGTCATTTCTA
CATCAATGTTGCAGACCCAA -> ATCAATGTTGCAGACCCAAT
GATAACGCGCCAGTGTGGTT -> ATAACGCGCCAGTGTGGTTC
GCAGTCCTGTGAACAATTTC -> CAGTCCTGTGAACAATTTCC
CCCCGGGCTAGTGTTCTCGG -> CCCGGGCTAGTGTTCTCGGA
AGGGGTTTGCGAGGTGCACG -> GGGGTTTGCGAGGTGCACGC
TAAGTAGTTTCAGGCGATGA -> AAGTAGTTTCAGGCGATGAC
ATTCCACGTAATACCGCCGA -> TTCCACGTAATACCGCCGAC
GCTCATCAATGTTGCAGACC -> CTCATCAATGTTGCAGACCC
TTAGTAATCTTGTGCAGTGG -> TAGTAATCTTGTGCAGTGGA
GCTTCGGTCCCCGACTCGAT -> CTTCGGTCCCCGACTCGATT
CATAGAGTCTAATCCCCGAC -> ATAGAGTCTAATCCCCGACT
CGGCGCTAAACACCGCACTG -> GGCGCTAAACACCGCACTGA
TAGAGACGGGGATGCCCGCT -> AGAGACGGGGATGCCCGCTC
GGCTGTCGAATAATAACCAA -> GCTGTCGAATAATAACCAAG
AGTTGCTCCACAAAATCGTA -> GTTGCTCCACAAAATCGTAG
AGGGCCGACAACAAAACCCC -> GGGCCGACAACAAAACCCCG
GCTAGAGACGGGGATGCCCG -> CTAGAGACGGGGATGCCCGC
CGGTGAGCCGCTAATGCCCC -> GGTGAGCCGCTAATGCCCCT
GGGATGCCCGCTCCTACAAT -> GGATGCCCGCTCCTACAATA
TAATTCCACGTAATACCGCC -> AATTCCACGTAATACCGCCG
AGAAGCTAGAGACGGGGATG -> GAAGCTAGAGACGGGGATGC
ACGCGGAGAGGCGCACTTGT -> CGCGGAGAGGCGCACTTGTG
TAAACACCGCACTGACGCTG -> AAACACCGCACTGACGCTGT
TACTCTAGCTGCTCTTTCGA -> ACTCTAGCTGCTCTTTCGAA
GACGATGAGCTGTATCTCGA -> ACGATGAGCTGTATCTCGAG
ACAACAAAACCCCGGGCTAG -> CAACAAAACCCCGGGCTAGT
GACTATTCGGCAGACTCTCC -> ACTATTCGGCAGACTCTCCA
AAACTATGACGATGAGCTGT -> AACTATGACGATGAGCTGTA
CTCCACAAAATCGTAGCTTC -> TCCACAAAATCGTAGCTTCG
TCTCCAGAGAGGAAGGTGTA -> CTCCAGAGAGGAAGGTGTAC
AGGATAACGGAATGCGAAGG -> GGATAACGGAATGCGAAGGC
TCGCCGAAAGGGGCCTTTAC -> CGCCGAAAGGGGCCTTTACT
CAACCGCACCTGAACGATCA -> AACCGCACCTGAACGATCAT
CAGTAAGTAAGTAGTTTCAG -> AGTAAGTAAGTAGTTTCAGG
TTACGCGTCGCAACTTAGTC -> TACGCGTCGCAACTTAGTCC
GATCTGGGTCGGGGATTCTC -> ATCTGGGTCGGGGATTCTCG
TCCTTCCCATGACGGAAACT -> CCTTCCCATGACGGAAACTG
TCCTGTGAACAATTTCCTGA -> CCTGTGAACAATTTCCTGAC
TGCAGACCCAATTAGTAATC -> GCAGACCCAATTAGTAATCT
GACGTCTACTTAGCCAGTTG -> ACGTCTACTTAGCCAGTTGC
CGAAGCCCAGTAAATCGATG -> GAAGCCCAGTAAATCGATGG
GCGAAGGCGATAATCCAGTA -> CGAAGGCGATAATCCAGTAA
GTAATACCGCCGACTATTCG -> TAATACCGCCGACTATTCGG
TTCAGGCGATGACATCACAG -> TCAGGCGATGACATCACAGG
ACGGCGCTAAACACCGCACT -> CGGCGCTAAACACCGCACTG
GTTACAAGTCGAACGCTCCG -> TTACAAGTCGAACGCTCCGG
TAATACCGCCGACTATTCGG -> AATACCGCCGACTATTCGGC
ACTATACTCTAGCTGCTCTT -> CTATACTCTAGCTGCTCTTT
GTGTAGGACCGTTCCTCGCA -> TGTAGGACCGTTCCTCGCAA
CCTTGATAACGCGCCAGTGT -> CTTGATAACGCGCCAGTGTG
GCGCACTTGTGTCTTCAAAT -> CGCACTTGTGTCTTCAAATG
ACTTAGCCAGTTGCTCCACA -> CTTAGCCAGTTGCTCCACAA
CCAGAGAGGAAGGTGTACAA -> CAGAGAGGAAGGTGTACAAA
GATGAGCTGTATCTCGAGGG -> ATGAGCTGTATCTCGAGGGG
AGCTGTATCTCGAGGGGTTT -> GCTGTATCTCGAGGGGTTTG
CTAAACACCGCACTGACGCT -> TAAACACCGCACTGACGCTG
TCGGCAGACTCTCCAGAGAG -> CGGCAGACTCTCCAGAGAGG
GTAAATCGATGGGCACGCGG -> TAAATCGATGGGCACGCGGA
ATCATCACTGGTCATTTCTA -> TCATCACTGGTCATTTCTAC
GGCCTACAAGCTCGCCGAAA -> GCCTACAAGCTCGCCGAAAG
GATTCACCGCATAGAGTCTA -> ATTCACCGCATAGAGTCTAA
GCTAGTGTTCTCGGATCTAA -> CTAGTGTTCTCGGATCTAAC
AGGCACCCCGATTCACCGCA -> GGCACCCCGATTCACCGCAT
TAGCTTCGGTCCCCGACTCG -> AGCTTCGGTCCCCGACTCGA
CGCGGAGAGGCGCACTTGTG -> GCGGAGAGGCGCACTTGTGT
AGTTTCAGGCGATGACATCA -> GTTTCAGGCGATGACATCAC
CGCGCCAGTGTGGTTCACTC -> GCGCCAGTGTGGTTCACTCG
TTGTGTCTTCAAATGGCTCA -> TGTGTCTTCAAATGGCTCAT
CTCATCAATGTTGCAGACCC -> TCATCAATGTTGCAGACCCA
CCCAGTAAATCGATGGGCAC -> CCAGTAAATCGATGGGCACG
TAGTGTTACATTCGCTGAGG -> AGTGTTACATTCGCTGAGGT
GACAACAAAACCCCGGGCTA -> ACAACAAAACCCCGGGCTAG
GGCACGCGGAGAGGCGCACT -> GCACGCGGAGAGGCGCACTT
CCCGCTCCTACAATAATTCC -> CCGCTCCTACAATAATTCCA
GTGGAGGTATTTTCAACCGC -> TGGAGGTATTTTCAACCGCA
CGACAACAAAACCCCGGGCT -> GACAACAAAACCCCGGGCTA
ACCGCATAGAGTCTAATCCC -> CCGCATAGAGTCTAATCCCC
TAGGAGGCACCCCGATTCAC -> AGGAGGCACCCCGATTCACC
GTTACATTCGCTGAGGTACG -> TTACATTCGCTGAGGTACGG
CCCGATTCACCGCATAGAGT -> CCGATTCACCGCATAGAGTC
CACAGGATAGATCTGGGTCG -> ACAGGATAGATCTGGGTCGG
TCTAATCCCCGACTTACGCG -> CTAATCCCCGACTTACGCGT
CGAAAGGGGCCTTTACTTCG -> GAAAGGGGCCTTTACTTCGT
CACTCGCCACGCAAGAGTTG -> ACTCGCCACGCAAGAGTTGG
TACATTCAATGGTACGGCTA -> ACATTCAATGGTACGGCTAA
TGGCAGTCCTGTGAACAATT -> GGCAGTCCTGTGAACAATTT
CCTGACGCTGGCTGTCGAAT -> CTGACGCTGGCTGTCGAATA
TAGAGTCTAATCCCCGACTT -> AGAGTCTAATCCCCGACTTA
AAACTGCTGTTACAAGTCGA -> AACTGCTGTTACAAGTCGAA
AAGAGGGCCGACAACAAAAC -> AGAGGGCCGACAACAAAACC
CATCCTTTGACGGTGAGCCG -> ATCCTTTGACGGTGAGCCGC
GCGAGGTGCACGCTAGTGTA -> CGAGGTGCACGCTAGTGTAG
TCTTCAAATGGCTCATCAAT -> CTTCAAATGGCTCATCAATG
CCGCCGACTATTCGGCAGAC -> CGCCGACTATTCGGCAGACT
ACGCTCTGTGTAGGACCGTT -> CGCTCTGTGTAGGACCGTTC
AGCCCAGTAAATCGATGGGC -> GCCCAGTAAATCGATGGGCA
CTTATAGTGTTACATTCGCT -> TTATAGTGTTACATTCGCTG
CTGTTACCGCTTATAGTGTT -> TGTTACCGCTTATAGTGTTA
CTAATGCCCCTTGATAACGC -> TAATGCCCCTTGATAACGCG
TTACGGCGCTAAACACCGCA -> TACGGCGCTAAACACCGCAC
AAGTAAGTAGTTTCAGGCGA -> AGTAAGTAGTTTCAGGCGAT
CCGCACCTGAACGATCATTG -> CGCACCTGAACGATCATTGG
CAAATGGCTCATCAATGTTG -> AAATGGCTCATCAATGTTGC
TGCTGTTACAAGTCGAACGC -> GCTGTTACAAGTCGAACGCT
GGCACCCCGATTCACCGCAT -> GCACCCCGATTCACCGCATA
CCCCGACTCGATTTTTACAT -> CCCGACTCGATTTTTACATT
TGTCTTCAAATGGCTCATCA -> GTCTTCAAATGGCTCATCAA
GAACGATCATTGGTGTACTA -> AACGATCATTGGTGTACTAT
GCACCTGAACGATCATTGGT -> CACCTGAACGATCATTGGTG
AGATTGGCAGTCCTGTGAAC -> GATTGGCAGTCCTGTGAACA
GCAGTGGAGGTATTTTCAAC -> CAGTGGAGGTATTTTCAACC
TACCGCCGACTATTCGGCAG -> ACCGCCGACTATTCGGCAGA
TTACTTCGTAAACAAAAATG -> TACTTCGTAAACAAAAATGT
TGGTCATTTCTACACAGATT -> GGTCATTTCTACACAGATTG
GAAGGTGTACAAAAGAGGGC -> AAGGTGTACAAAAGAGGGCC
ATGAATACACGCTCTGTGTA -> TGAATACACGCTCTGTGTAG
CAACTTAGTCCTTCCCATGA -> AACTTAGTCCTTCCCATGAC
TCTTTCGAATCAGACTTACG -> CTTTCGAATCAGACTTACGG
ATCGATGGGCACGCGGAGAG -> TCGATGGGCACGCGGAGAGG
ACCGCACTGACGCTGTTACC -> CCGCACTGACGCTGTTACCG
CACGCGGAGAGGCGCACTTG -> ACGCGGAGAGGCGCACTTGT
CCGTTCCTCGCAAATCGTGG -> CGTTCCTCGCAAATCGTGGC
ACAAGTCGAACGCTCCGGCT -> CAAGTCGAACGCTCCGGCTA
TCATCACTGGTCATTTCTAC -> CATCACTGGTCATTTCTACA
ATGACATCACAGGATAGATC -> TGACATCACAGGATAGATCT
TGACGCTGTTACCGCTTATA -> GACGCTGTTACCGCTTATAG
AATGTCGTCCGATAGGGGAC -> ATGTCGTCCGATAGGGGACT
GTACGGCGCTCAGCGCTGAC -> TACGGCGCTCAGCGCTGACG
ATCTAACTAGGAGGCACCCC -> TCTAACTAGGAGGCACCCCG
TCGCAAATCGTGGCCTACAA -> CGCAAATCGTGGCCTACAAG
GAGCTGTATCTCGAGGGGTT -> AGCTGTATCTCGAGGGGTTT
TCTAGCTGCTCTTTCGAATC -> CTAGCTGCTCTTTCGAATCA
TTCCTGACGCTGGCTGTCGA -> TCCTGACGCTGGCTGTCGAA
ACAGATTGGCAGTCCTGTGA -> CAGATTGGCAGTCCTGTGAA
AATAATTCCACGTAATACCG -> ATAATTCCACGTAATACCGC
AGCAAGGATAACGGAATGCG -> GCAAGGATAACGGAATGCGA
TCAGGCGATGACATCACAGG -> CAGGCGATGACATCACAGGA
GGATCATCACTGGTCATTTC -> GATCATCACTGGTCATTTCT
ATTCGCTGAGGTACGGCGCT -> TTCGCTGAGGTACGGCGCTC
TCGAATAATAACCAAGAAGC -> CGAATAATAACCAAGAAGCT
CGCCGAAAGGGGCCTTTACT -> GCCGAAAGGGGCCTTTACTT
ACATTCGCTGAGGTACGGCG -> CATTCGCTGAGGTACGGCGC
TACCGCTTATAGTGTTACAT -> ACCGCTTATAGTGTTACATT
GACATCACAGGATAGATCTG -> ACATCACAGGATAGATCTGG
GCAACTTAGTCCTTCCCATG -> CAACTTAGTCCTTCCCATGA
CTATACTCTAGCTGCTCTTT -> TATACTCTAGCTGCTCTTTC
GTTGCTCCACAAAATCGTAG -> TTGCTCCACAAAATCGTAGC
AGACGGGGATGCCCGCTCCT -> GACGGGGATGCCCGCTCCTA
TACGGCTAAACTATGACGAT -> ACGGCTAAACTATGACGATG
GCCGACTATTCGGCAGACTC -> CCGACTATTCGGCAGACTCT
GCTCCACAAAATCGTAGCTT -> CTCCACAAAATCGTAGCTTC
ACAAAATCGTAGCTTCGGTC -> CAAAATCGTAGCTTCGGTCC
AGACTTACGGCGCTAAACAC -> GACTTACGGCGCTAAACACC
AGACCCAATTAGTAATCTTG -> GACCCAATTAGTAATCTTGT
TAGTAATCTTGTGCAGTGGA -> AGTAATCTTGTGCAGTGGAG
AGTCCTTCCCATGACGGAAA -> GTCCTTCCCATGACGGAAAC
AAGCAAGGATAACGGAATGC -> AGCAAGGATAACGGAATGCG
GGTTCACTCGCCACGCAAGA -> GTTCACTCGCCACGCAAGAG
ACTTACGCGTCGCAACTTAG -> CTTACGCGTCGCAACTTAGT
CATCACAGGATAGATCTGGG -> ATCACAGGATAGATCTGGGT
GAGTAAGCAAGGATAACGGA -> AGTAAGCAAGGATAACGGAA
TCGGATCTAACTAGGAGGCA -> CGGATCTAACTAGGAGGCAC
GTCTACTTAGCCAGTTGCTC -> TCTACTTAGCCAGTTGCTCC
TTCTCGGATCTAACTAGGAG -> TCTCGGATCTAACTAGGAGG
TTGCAGACCCAATTAGTAAT -> TGCAGACCCAATTAGTAATC
GTGTACAAAAGAGGGCCGAC -> TGTACAAAAGAGGGCCGACA
CCCCTTGATAACGCGCCAGT -> CCCTTGATAACGCGCCAGTG
AAATCGATGGGCACGCGGAG -> AATCGATGGGCACGCGGAGA
GGATAGATCTGGGTCGGGGA -> GATAGATCTGGGTCGGGGAT
CGGGGATGCCCGCTCCTACA -> GGGGATGCCCGCTCCTACAA
GATAGGGGACTGCCAGTAAC -> ATAGGGGACTGCCAGTAACT
AATGCCCCTTGATAACGCGC -> ATGCCCCTTGATAACGCGCC
CAATGTTGCAGACCCAATTA -> AATGTTGCAGACCCAATTAG
GTGCACGCTAGTGTAGAGTA -> TGCACGCTAGTGTAGAGTAA
AGATCTGGGTCGGGGATTCT -> GATCTGGGTCGGGGATTCTC
AATGGTACGGCTAAACTATG -> ATGGTACGGCTAAACTATGA
ACAAAAATGTCGTCCGATAG -> CAAAAATGTCGTCCGATAGG
CGCTTATAGTGTTACATTCG -> GCTTATAGTGTTACATTCGC
CCAGTAAGTAAGTAGTTTCA -> CAGTAAGTAAGTAGTTTCAG
TTGACGGTGAGCCGCTAATG -> TGACGGTGAGCCGCTAATGC
GCACTTGTGTCTTCAAATGG -> CACTTGTGTCTTCAAATGGC
CGCTAATGCCCCTTGATAAC -> GCTAATGCCCCTTGATAACG
CTTTCGAATCAGACTTACGG -> TTTCGAATCAGACTTACGGC
GTTCCTCGCAAATCGTGGCC -> TTCCTCGCAAATCGTGGCCT
GGTATTTTCAACCGCACCTG -> GTATTTTCAACCGCACCTGA
CCCGGGCTAGTGTTCTCGGA -> CCGGGCTAGTGTTCTCGGAT
AAGAAGCTAGAGACGGGGAT -> AGAAGCTAGAGACGGGGATG
ATACCGCCGACTATTCGGCA -> TACCGCCGACTATTCGGCAG
GATGCCCGCTCCTACAATAA -> ATGCCCGCTCCTACAATAAT
TCAAATGGCTCATCAATGTT -> CAAATGGCTCATCAATGTTG
ATCAGACTTACGGCGCTAAA -> TCAGACTTACGGCGCTAAAC
TTTCGAATCAGACTTACGGC -> TTCGAATCAGACTTACGGCG
CACCGCACTGACGCTGTTAC -> ACCGCACTGACGCTGTTACC
CTCGAGGGGTTTGCGAGGTG -> TCGAGGGGTTTGCGAGGTGC
AATGTTGCAGACCCAATTAG -> ATGTTGCAGACCCAATTAGT
GATGGGCACGCGGAGAGGCG -> ATGGGCACGCGGAGAGGCGC
ATCAATGTTGCAGACCCAAT -> TCAATGTTGCAGACCCAATT
CGCCAGTGTGGTTCACTCGC -> GCCAGTGTGGTTCACTCGCC
CGATGAATACACGCTCTGTG -> GATGAATACACGCTCTGTGT
GGGTGGATCATCACTGGTCA -> GGTGGATCATCACTGGTCAT
TAACCAAGAAGCTAGAGACG -> AACCAAGAAGCTAGAGACGG
GCTGGCTGTCGAATAATAAC -> CTGGCTGTCGAATAATAACC
GGTGCACGCTAGTGTAGAGT -> GTGCACGCTAGTGTAGAGTA
CAGACCCAATTAGTAATCTT -> AGACCCAATTAGTAATCTTG
AGCTCGCCGAAAGGGGCCTT -> GCTCGCCGAAAGGGGCCTTT
AGAGGCGCACTTGTGTCTTC -> GAGGCGCACTTGTGTCTTCA
AGCCGCTAATGCCCCTTGAT -> GCCGCTAATGCCCCTTGATA
CAAAACCCCGGGCTAGTGTT -> AAAACCCCGGGCTAGTGTTC
ACAAAACCCCGGGCTAGTGT -> CAAAACCCCGGGCTAGTGTT
AAGTCGAACGCTCCGGCTAG -> AGTCGAACGCTCCGGCTAGG
GTTCACTCGCCACGCAAGAG -> TTCACTCGCCACGCAAGAGT
AGTAATCTTGTGCAGTGGAG -> GTAATCTTGTGCAGTGGAGG
AACAATTTCCTGACGCTGGC -> ACAATTTCCTGACGCTGGCT
AGGGGCCTTTACTTCGTAAA -> GGGGCCTTTACTTCGTAAAC
TCAGACTTACGGCGCTAAAC -> CAGACTTACGGCGCTAAACA
TCGGTCCCCGACTCGATTTT -> CGGTCCCCGACTCGATTTTT
GAAAGGGGCCTTTACTTCGT -> AAAGGGGCCTTTACTTCGTA
TGAGCCGCTAATGCCCCTTG -> GAGCCGCTAATGCCCCTTGA
GCAAGGATAACGGAATGCGA -> CAAGGATAACGGAATGCGAA
CTTCAAATGGCTCATCAATG -> TTCAAATGGCTCATCAATGT
CGAGGTGCACGCTAGTGTAG -> GAGGTGCACGCTAGTGTAGA
CGATAATCCAGTAAGTAAGT -> GATAATCCAGTAAGTAAGTA
ATTCACCGCATAGAGTCTAA -> TTCACCGCATAGAGTCTAAT
AATTCCACGTAATACCGCCG -> ATTCCACGTAATACCGCCGA
ATCACAGGATAGATCTGGGT -> TCACAGGATAGATCTGGGTC
TTACAAGTCGAACGCTCCGG -> TACAAGTCGAACGCTCCGGC
CGATAGGGGACTGCCAGTAA -> GATAGGGGACTGCCAGTAAC
CACTGGTCATTTCTACACAG -> ACTGGTCATTTCTACACAGA
TCTCGATGAATACACGCTCT -> CTCGATGAATACACGCTCTG
TTGCGAAGCCCAGTAAATCG -> TGCGAAGCCCAGTAAATCGA
GAAACTGCTGTTACAAGTCG -> AAACTGCTGTTACAAGTCGA
CCAGTGTGGTTCACTCGCCA -> CAGTGTGGTTCACTCGCCAC
GGTCGGGGATTCTCGATGAA -> GTCGGGGATTCTCGATGAAT
TCAACCGCACCTGAACGATC -> CAACCGCACCTGAACGATCA
TTCCCATGACGGAAACTGCT -> TCCCATGACGGAAACTGCTG
GTAGAGTAAGCAAGGATAAC -> TAGAGTAAGCAAGGATAACG
AGTGTAGAGTAAGCAAGGAT -> GTGTAGAGTAAGCAAGGATA
ACAATTTCCTGACGCTGGCT -> CAATTTCCTGACGCTGGCTG
CTGGTCATTTCTACACAGAT -> TGGTCATTTCTACACAGATT
CCTACAATAATTCCACGTAA -> CTACAATAATTCCACGTAAT
CCTTTACTTCGTAAACAAAA -> CTTTACTTCGTAAACAAAAA
GGGGTTTGCGAGGTGCACGC -> GGGTTTGCGAGGTGCACGCT
TTTTACATTCAATGGTACGG -> TTTACATTCAATGGTACGGC
CCGACAACAAAACCCCGGGC -> CGACAACAAAACCCCGGGCT
AAGGTGTACAAAAGAGGGCC -> AGGTGTACAAAAGAGGGCCG
TCGATGGGCACGCGGAGAGG -> CGATGGGCACGCGGAGAGGC
GGATTCTCGATGAATACACG -> GATTCTCGATGAATACACGC
CAAGTCGAACGCTCCGGCTA -> AAGTCGAACGCTCCGGCTAG
GGCTAGTGTTCTCGGATCTA -> GCTAGTGTTCTCGGATCTAA
CTACAAGCTCGCCGAAAGGG -> TACAAGCTCGCCGAAAGGGG
GACGGAAACTGCTGTTACAA -> ACGGAAACTGCTGTTACAAG
TCACTCGCCACGCAAGAGTT -> CACTCGCCACGCAAGAGTTG
TGGTTCACTCGCCACGCAAG -> GGTTCACTCGCCACGCAAGA
GAGTTGGGTGGATCATCACT -> AGTTGGGTGGATCATCACTG
GGGCACGCGGAGAGGCGCAC -> GGCACGCGGAGAGGCGCACT
ACGATGAGCTGTATCTCGAG -> CGATGAGCTGTATCTCGAGG
CACCGCATAGAGTCTAATCC -> ACCGCATAGAGTCTAATCCC
TGTACTATACTCTAGCTGCT -> GTACTATACTCTAGCTGCTC
TACGGCGCTAAACACCGCAC -> ACGGCGCTAAACACCGCACT
GTTACCGCTTATAGTGTTAC -> TTACCGCTTATAGTGTTACA
ACGCTGGCTGTCGAATAATA -> CGCTGGCTGTCGAATAATAA
CAAAAGAGGGCCGACAACAA -> AAAAGAGGGCCGACAACAAA
ACCGCACCTGAACGATCATT -> CCGCACCTGAACGATCATTG
CCGCACTGACGCTGTTACCG -> CGCACTGACGCTGTTACCGC
GGGGCCTTTACTTCGTAAAC -> GGGCCTTTACTTCGTAAACA
ACATTCAATGGTACGGCTAA -> CATTCAATGGTACGGCTAAA
CTAGGAGGCACCCCGATTCA -> TAGGAGGCACCCCGATTCAC
GAAGGCGATAATCCAGTAAG -> AAGGCGATAATCCAGTAAGT
AGGAAGGTGTACAAAAGAGG -> GGAAGGTGTACAAAAGAGGG
CGCAACTTAGTCCTTCCCAT -> GCAACTTAGTCCTTCCCATG
TTAGCCAGTTGCTCCACAAA -> TAGCCAGTTGCTCCACAAAA
TTACCGCTTATAGTGTTACA -> TACCGCTTATAGTGTTACAT
ATGCGAAGGCGATAATCCAG -> TGCGAAGGCGATAATCCAGT
GAGGTACGGCGCTCAGCGCT -> AGGTACGGCGCTCAGCGCTG
TGAACGATCATTGGTGTACT -> GAACGATCATTGGTGTACTA
CTACACAGATTGGCAGTCCT -> TACACAGATTGGCAGTCCTG
TGTTACATTCGCTGAGGTAC -> GTTACATTCGCTGAGGTACG
CCCGACTCGATTTTTACATT -> CCGACTCGATTTTTACATTC
AATCGTGGCCTACAAGCTCG -> ATCGTGGCCTACAAGCTCGC
TAGAGTAAGCAAGGATAACG -> AGAGTAAGCAAGGATAACGG
GTTCTCGGATCTAACTAGGA -> TTCTCGGATCTAACTAGGAG
GCTAAACTATGACGATGAGC -> CTAAACTATGACGATGAGCT
AGCTTCGGTCCCCGACTCGA -> GCTTCGGTCCCCGACTCGAT
GTGTTACATTCGCTGAGGTA -> TGTTACATTCGCTGAGGTAC
GCACCCCGATTCACCGCATA -> CACCCCGATTCACCGCATAG
TCCTACAATAATTCCACGTA -> CCTACAATAATTCCACGTAA
CGGGCTAGTGTTCTCGGATC -> GGGCTAGTGTTCTCGGATCT
CGGAAACTGCTGTTACAAGT -> GGAAACTGCTGTTACAAGTC
GTACAAAAGAGGGCCGACAA -> TACAAAAGAGGGCCGACAAC
TGCAGTGGAGGTATTTTCAA -> GCAGTGGAGGTATTTTCAAC
AGTGTGGTTCACTCGCCACG -> GTGTGGTTCACTCGCCACGC
ATAACGCGCCAGTGTGGTTC -> TAACGCGCCAGTGTGGTTCA
GAGGCACCCCGATTCACCGC -> AGGCACCCCGATTCACCGCA
GGCGCTCAGCGCTGACGTCT -> GCGCTCAGCGCTGACGTCTA
CTGTATCTCGAGGGGTTTGC -> TGTATCTCGAGGGGTTTGCG
TCATTGGTGTACTATACTCT -> CATTGGTGTACTATACTCTA
CTAGGTCCTCCCCACGATAT -> TAGGTCCTCCCCACGATATT
TCCTCGCAAATCGTGGCCTA -> CCTCGCAAATCGTGGCCTAC
GCTAAACACCGCACTGACGC -> CTAAACACCGCACTGACGCT
TGTTCTCGGATCTAACTAGG -> GTTCTCGGATCTAACTAGGA
CCCCGACTTACGCGTCGCAA -> CCCGACTTACGCGTCGCAAC
TCCGGCTAGGTCCTCCCCAC -> CCGGCTAGGTCCTCCCCACG
TTTTTACATTCAATGGTACG -> TTTTACATTCAATGGTACGG
TTCGGTCCCCGACTCGATTT -> TCGGTCCCCGACTCGATTTT
CTATTCGGCAGACTCTCCAG -> TATTCGGCAGACTCTCCAGA
TAAACAAAAATGTCGTCCGA -> AAACAAAAATGTCGTCCGAT
ACAAGCTCGCCGAAAGGGGC -> CAAGCTCGCCGAAAGGGGCC
AAAATCGTAGCTTCGGTCCC -> AAATCGTAGCTTCGGTCCCC
AATCAGACTTACGGCGCTAA -> ATCAGACTTACGGCGCTAAA
GCCTACAAGCTCGCCGAAAG -> CCTACAAGCTCGCCGAAAGG
GACGCTGTTACCGCTTATAG -> ACGCTGTTACCGCTTATAGT
TAGTGTAGAGTAAGCAAGGA -> AGTGTAGAGTAAGCAAGGAT
GCTGACGTCTACTTAGCCAG -> CTGACGTCTACTTAGCCAGT
TAGTCCTTCCCATGACGGAA -> AGTCCTTCCCATGACGGAAA
TACAATAATTCCACGTAATA -> ACAATAATTCCACGTAATAC
CAGACTTACGGCGCTAAACA -> AGACTTACGGCGCTAAACAC
GGCGCACTTGTGTCTTCAAA -> GCGCACTTGTGTCTTCAAAT
TGGAGGTATTTTCAACCGCA -> GGAGGTATTTTCAACCGCAC
CCACGTAATACCGCCGACTA -> CACGTAATACCGCCGACTAT
CAGATTGGCAGTCCTGTGAA -> AGATTGGCAGTCCTGTGAAC
AAAACCCCGGGCTAGTGTTC -> AAACCCCGGGCTAGTGTTCT
TTTACATTCAATGGTACGGC -> TTACATTCAATGGTACGGCT
TGCTCCACAAAATCGTAGCT -> GCTCCACAAAATCGTAGCTT
TGTGTAGGACCGTTCCTCGC -> GTGTAGGACCGTTCCTCGCA
CAGTTGCTCCACAAAATCGT -> AGTTGCTCCACAAAATCGTA
CCATGACGGAAACTGCTGTT -> CATGACGGAAACTGCTGTTA
GTTTGCGAGGTGCACGCTAG -> TTTGCGAGGTGCACGCTAGT
GGAAGGTGTACAAAAGAGGG -> GAAGGTGTACAAAAGAGGGC
GCAGACCCAATTAGTAATCT -> CAGACCCAATTAGTAATCTT
TTCACTCGCCACGCAAGAGT -> TCACTCGCCACGCAAGAGTT
GTAGCTTCGGTCCCCGACTC -> TAGCTTCGGTCCCCGACTCG
GGGCCGACAACAAAACCCCG -> GGCCGACAACAAAACCCCGG
CCGACTATTCGGCAGACTCT -> CGACTATTCGGCAGACTCTC
ATCCAGTAAGTAAGTAGTTT -> TCCAGTAAGTAAGTAGTTTC
GATAATCCAGTAAGTAAGTA -> ATAATCCAGTAAGTAAGTAG
CGATGACATCACAGGATAGA -> GATGACATCACAGGATAGAT
GGGGATTCTCGATGAATACA -> GGGATTCTCGATGAATACAC
TGGCCTACAAGCTCGCCGAA -> GGCCTACAAGCTCGCCGAAA
GCGAAGCCCAGTAAATCGAT -> CGAAGCCCAGTAAATCGATG
CCGGGCTAGTGTTCTCGGAT -> CGGGCTAGTGTTCTCGGATC
GCGGAGAGGCGCACTTGTGT -> CGGAGAGGCGCACTTGTGTC
ACAATAATTCCACGTAATAC -> CAATAATTCCACGTAATACC
TCAATGTTGCAGACCCAATT -> CAATGTTGCAGACCCAATTA
GCACTGACGCTGTTACCGCT -> CACTGACGCTGTTACCGCTT
GTCTTCAAATGGCTCATCAA -> TCTTCAAATGGCTCATCAAT
TTTCCTGACGCTGGCTGTCG -> TTCCTGACGCTGGCTGTCGA
CTCCTACAATAATTCCACGT -> TCCTACAATAATTCCACGTA
CGTAATACCGCCGACTATTC -> GTAATACCGCCGACTATTCG
ATGGCTCATCAATGTTGCAG -> TGGCTCATCAATGTTGCAGA
GCGATGACATCACAGGATAG -> CGATGACATCACAGGATAGA
TGACGGAAACTGCTGTTACA -> GACGGAAACTGCTGTTACAA
AACTATGACGATGAGCTGTA -> ACTATGACGATGAGCTGTAT
TCGCTGAGGTACGGCGCTCA -> CGCTGAGGTACGGCGCTCAG
AGCCAGTTGCTCCACAAAAT -> GCCAGTTGCTCCACAAAATC
GAACGCTCCGGCTAGGTCCT -> AACGCTCCGGCTAGGTCCTC
AAATGGCTCATCAATGTTGC -> AATGGCTCATCAATGTTGCA
AAAAGAGGGCCGACAACAAA -> AAAGAGGGCCGACAACAAAA
TCCACGTAATACCGCCGACT -> CCACGTAATACCGCCGACTA
TCAATGGTACGGCTAAACTA -> CAATGGTACGGCTAAACTAT
AAACCCCGGGCTAGTGTTCT -> AACCCCGGGCTAGTGTTCTC
AGTCGAACGCTCCGGCTAGG -> GTCGAACGCTCCGGCTAGGT
GCACGCGGAGAGGCGCACTT -> CACGCGGAGAGGCGCACTTG
TCTTGTGCAGTGGAGGTATT -> CTTGTGCAGTGGAGGTATTT
GGTTTGCGAGGTGCACGCTA -> GTTTGCGAGGTGCACGCTAG
GGTACGGCTAAACTATGACG -> GTACGGCTAAACTATGACGA
CGCTCAGCGCTGACGTCTAC -> GCTCAGCGCTGACGTCTACT
GGTGTACTATACTCTAGCTG -> GTGTACTATACTCTAGCTGC
CGACTTACGCGTCGCAACTT -> GACTTACGCGTCGCAACTTA
TCGATTTTTACATTCAATGG -> CGATTTTTACATTCAATGGT
ACGGGGATGCCCGCTCCTAC -> CGGGGATGCCCGCTCCTACA
CCGCTAATGCCCCTTGATAA -> CGCTAATGCCCCTTGATAAC
GCCACGCAAGAGTTGGGTGG -> CCACGCAAGAGTTGGGTGGA
GGGTTTGCGAGGTGCACGCT -> GGTTTGCGAGGTGCACGCTA
CATTCGCTGAGGTACGGCGC -> ATTCGCTGAGGTACGGCGCT
CTTCCCATGACGGAAACTGC -> TTCCCATGACGGAAACTGCT
TGTCGTCCGATAGGGGACTG -> GTCGTCCGATAGGGGACTGC
GTACTATACTCTAGCTGCTC -> TACTATACTCTAGCTGCTCT
TATACTCTAGCTGCTCTTTC -> ATACTCTAGCTGCTCTTTCG
CAGTCCTGTGAACAATTTCC -> AGTCCTGTGAACAATTTCCT
CGGAGAGGCGCACTTGTGTC -> GGAGAGGCGCACTTGTGTCT
GTCCTCCCCACGATATTGCG -> TCCTCCCCACGATATTGCGA
CCGACTTACGCGTCGCAACT -> CGACTTACGCGTCGCAACTT
GAGGCGCACTTGTGTCTTCA -> AGGCGCACTTGTGTCTTCAA
TATGACGATGAGCTGTATCT -> ATGACGATGAGCTGTATCTC
ACTTCGTAAACAAAAATGTC -> CTTCGTAAACAAAAATGTCG
GTGTGGTTCACTCGCCACGC -> TGTGGTTCACTCGCCACGCA
CGCCGACTATTCGGCAGACT -> GCCGACTATTCGGCAGACTC
TGAGGTACGGCGCTCAGCGC -> GAGGTACGGCGCTCAGCGCT
TATTGCGAAGCCCAGTAAAT -> ATTGCGAAGCCCAGTAAATC
TAATCCCCGACTTACGCGTC -> AATCCCCGACTTACGCGTCG
AATGCGAAGGCGATAATCCA -> ATGCGAAGGCGATAATCCAG
GACTTACGCGTCGCAACTTA -> ACTTACGCGTCGCAACTTAG
AATCGTAGCTTCGGTCCCCG -> ATCGTAGCTTCGGTCCCCGA
AGGTACGGCGCTCAGCGCTG -> GGTACGGCGCTCAGCGCTGA
TGGTGTACTATACTCTAGCT -> GGTGTACTATACTCTAGCTG
AACAAAAATGTCGTCCGATA -> ACAAAAATGTCGTCCGATAG
CCAAGAAGCTAGAGACGGGG -> CAAGAAGCTAGAGACGGGGA
ACTCGATTTTTACATTCAAT -> CTCGATTTTTACATTCAATG
TTGTGCAGTGGAGGTATTTT -> TGTGCAGTGGAGGTATTTTC
CAACAAAACCCCGGGCTAGT -> AACAAAACCCCGGGCTAGTG
TTATAGTGTTACATTCGCTG -> TATAGTGTTACATTCGCTGA
TACAAGTCGAACGCTCCGGC -> ACAAGTCGAACGCTCCGGCT
ATTCGGCAGACTCTCCAGAG -> TTCGGCAGACTCTCCAGAGA
GAACAATTTCCTGACGCTGG -> AACAATTTCCTGACGCTGGC
TCCAGTAAGTAAGTAGTTTC -> CCAGTAAGTAAGTAGTTTCA
AACGGAATGCGAAGGCGATA -> ACGGAATGCGAAGGCGATAA
ATATTGCGAAGCCCAGTAAA -> TATTGCGAAGCCCAGTAAAT
CGCTCCTACAATAATTCCAC -> GCTCCTACAATAATTCCACG
GAGGGCCGACAACAAAACCC -> AGGGCCGACAACAAAACCCC
CTTTGACGGTGAGCCGCTAA -> TTTGACGGTGAGCCGCTAAT
ATTTCCTGACGCTGGCTGTC -> TTTCCTGACGCTGGCTGTCG
ATAACGGAATGCGAAGGCGA -> TAACGGAATGCGAAGGCGAT
GAGACGGGGATGCCCGCTCC -> AGACGGGGATGCCCGCTCCT
CGAATCAGACTTACGGCGCT -> GAATCAGACTTACGGCGCTA
CGTAAACAAAAATGTCGTCC -> GTAAACAAAAATGTCGTCCG
TAACTAGGAGGCACCCCGAT -> AACTAGGAGGCACCCCGATT
ACTGGTCATTTCTACACAGA -> CTGGTCATTTCTACACAGAT
CTTGATAACGCGCCAGTGTG -> TTGATAACGCGCCAGTGTGG
TTCACCGCATAGAGTCTAAT -> TCACCGCATAGAGTCTAATC
ATAATCCAGTAAGTAAGTAG -> TAATCCAGTAAGTAAGTAGT
GGATGCCCGCTCCTACAATA -> GATGCCCGCTCCTACAATAA
CTCGCCACGCAAGAGTTGGG -> TCGCCACGCAAGAGTTGGGT
ATGCCCGCTCCTACAATAAT -> TGCCCGCTCCTACAATAATT
AGTAAGTAAGTAGTTTCAGG -> GTAAGTAAGTAGTTTCAGGC
TTGGTGTACTATACTCTAGC -> TGGTGTACTATACTCTAGCT
CAGTAAATCGATGGGCACGC -> AGTAAATCGATGGGCACGCG
ACTTGTGTCTTCAAATGGCT -> CTTGTGTCTTCAAATGGCTC
GGACCGTTCCTCGCAAATCG -> GACCGTTCCTCGCAAATCGT
GTCCCCGACTCGATTTTTAC -> TCCCCGACTCGATTTTTACA
CTCCGGCTAGGTCCTCCCCA -> TCCGGCTAGGTCCTCCCCAC
GAAGCTAGAGACGGGGATGC -> AAGCTAGAGACGGGGATGCC
TGTTGCAGACCCAATTAGTA -> GTTGCAGACCCAATTAGTAA
CCCAATTAGTAATCTTGTGC -> CCAATTAGTAATCTTGTGCA
AGAGTAAGCAAGGATAACGG -> GAGTAAGCAAGGATAACGGA
TACTATACTCTAGCTGCTCT -> ACTATACTCTAGCTGCTCTT
ACGCGCCAGTGTGGTTCACT -> CGCGCCAGTGTGGTTCACTC
GATCTAACTAGGAGGCACCC -> ATCTAACTAGGAGGCACCCC
ACAGGATAGATCTGGGTCGG -> CAGGATAGATCTGGGTCGGG
TAATCCAGTAAGTAAGTAGT -> AATCCAGTAAGTAAGTAGTT
TGACGCTGGCTGTCGAATAA -> GACGCTGGCTGTCGAATAAT
TGGTACGGCTAAACTATGAC -> GGTACGGCTAAACTATGACG
TCTCGAGGGGTTTGCGAGGT -> CTCGAGGGGTTTGCGAGGTG
AGTAAATCGATGGGCACGCG -> GTAAATCGATGGGCACGCGG
CACTGACGCTGTTACCGCTT -> ACTGACGCTGTTACCGCTTA
GCGCCAGTGTGGTTCACTCG -> CGCCAGTGTGGTTCACTCGC
TCTCGGATCTAACTAGGAGG -> CTCGGATCTAACTAGGAGGC
AGTGGAGGTATTTTCAACCG -> GTGGAGGTATTTTCAACCGC
GTGCAGTGGAGGTATTTTCA -> TGCAGTGGAGGTATTTTCAA
ATCTCGAGGGGTTTGCGAGG -> TCTCGAGGGGTTTGCGAGGT
GGCCTTTACTTCGTAAACAA -> GCCTTTACTTCGTAAACAAA
ATGGGCACGCGGAGAGGCGC -> TGGGCACGCGGAGAGGCGCA
GCAAATCGTGGCCTACAAGC -> CAAATCGTGGCCTACAAGCT
ACTGACGCTGTTACCGCTTA -> CTGACGCTGTTACCGCTTAT
CTCAGCGCTGACGTCTACTT -> TCAGCGCTGACGTCTACTTA
TGCACGCTAGTGTAGAGTAA -> GCACGCTAGTGTAGAGTAAG
GTCCGATAGGGGACTGCCAG -> TCCGATAGGGGACTGCCAGT
CGTCGCAACTTAGTCCTTCC -> GTCGCAACTTAGTCCTTCCC
TCCCCGACTTACGCGTCGCA -> CCCCGACTTACGCGTCGCAA
AACTGCTGTTACAAGTCGAA -> ACTGCTGTTACAAGTCGAAC
TGAATACACGCTCTGTGTAG -> GAATACACGCTCTGTGTAGG
CTAGTGTTCTCGGATCTAAC -> TAGTGTTCTCGGATCTAACT
CTGACGCTGGCTGTCGAATA -> TGACGCTGGCTGTCGAATAA
AGTAAGCAAGGATAACGGAA -> GTAAGCAAGGATAACGGAAT
AAAATGTCGTCCGATAGGGG -> AAATGTCGTCCGATAGGGGA
AGGTCCTCCCCACGATATTG -> GGTCCTCCCCACGATATTGC
GATAGATCTGGGTCGGGGAT -> ATAGATCTGGGTCGGGGATT
GGCTCATCAATGTTGCAGAC -> GCTCATCAATGTTGCAGACC
ACGCAAGAGTTGGGTGGATC -> CGCAAGAGTTGGGTGGATCA
GCTAGGTCCTCCCCACGATA -> CTAGGTCCTCCCCACGATAT
AGCGCTGACGTCTACTTAGC -> GCGCTGACGTCTACTTAGCC
CTGCTCTTTCGAATCAGACT -> TGCTCTTTCGAATCAGACTT
TTTCAGGCGATGACATCACA -> TTCAGGCGATGACATCACAG
TGGCTGTCGAATAATAACCA -> GGCTGTCGAATAATAACCAA
ATGGTACGGCTAAACTATGA -> TGGTACGGCTAAACTATGAC
CGAATAATAACCAAGAAGCT -> GAATAATAACCAAGAAGCTA
AGTTGGGTGGATCATCACTG -> GTTGGGTGGATCATCACTGG
ACGGCGCTCAGCGCTGACGT -> CGGCGCTCAGCGCTGACGTC
GCTCGCCGAAAGGGGCCTTT -> CTCGCCGAAAGGGGCCTTTA
TCACAGGATAGATCTGGGTC -> CACAGGATAGATCTGGGTCG
GTCTAATCCCCGACTTACGC -> TCTAATCCCCGACTTACGCG
GAATAATAACCAAGAAGCTA -> AATAATAACCAAGAAGCTAG
CTGACGTCTACTTAGCCAGT -> TGACGTCTACTTAGCCAGTT
AACCGCACCTGAACGATCAT -> ACCGCACCTGAACGATCATT
GCGCTAAACACCGCACTGAC -> CGCTAAACACCGCACTGACG
ACGATATTGCGAAGCCCAGT -> CGATATTGCGAAGCCCAGTA
CAGGATAGATCTGGGTCGGG -> AGGATAGATCTGGGTCGGGG
GACGGTGAGCCGCTAATGCC -> ACGGTGAGCCGCTAATGCCC
AGAGTTGGGTGGATCATCAC -> GAGTTGGGTGGATCATCACT
AGGCGCACTTGTGTCTTCAA -> GGCGCACTTGTGTCTTCAAA
GTACGGCTAAACTATGACGA -> TACGGCTAAACTATGACGAT
GGAGAGGCGCACTTGTGTCT -> GAGAGGCGCACTTGTGTCTT
TACAAAAGAGGGCCGACAAC -> ACAAAAGAGGGCCGACAACA
CGCAAGAGTTGGGTGGATCA -> GCAAGAGTTGGGTGGATCAT
TCGAACGCTCCGGCTAGGTC -> CGAACGCTCCGGCTAGGTCC
ACCGCTTATAGTGTTACATT -> CCGCTTATAGTGTTACATTC
GTGGCCTACAAGCTCGCCGA -> TGGCCTACAAGCTCGCCGAA
CGCTCTGTGTAGGACCGTTC -> GCTCTGTGTAGGACCGTTCC
CACAAAATCGTAGCTTCGGT -> ACAAAATCGTAGCTTCGGTC
GTCCTTCCCATGACGGAAAC -> TCCTTCCCATGACGGAAACT
GCACGCTAGTGTAGAGTAAG -> CACGCTAGTGTAGAGTAAGC
AAGCTAGAGACGGGGATGCC -> AGCTAGAGACGGGGATGCCC
CTTAGTCCTTCCCATGACGG -> TTAGTCCTTCCCATGACGGA
AACTAGGAGGCACCCCGATT -> ACTAGGAGGCACCCCGATTC
CTATGACGATGAGCTGTATC -> TATGACGATGAGCTGTATCT
ATCTTGTGCAGTGGAGGTAT -> TCTTGTGCAGTGGAGGTATT
ACGGTGAGCCGCTAATGCCC -> CGGTGAGCCGCTAATGCCCC
TGACGGTGAGCCGCTAATGC -> GACGGTGAGCCGCTAATGCC
CTTACGCGTCGCAACTTAGT -> TTACGCGTCGCAACTTAGTC
GCTTATAGTGTTACATTCGC -> CTTATAGTGTTACATTCGCT
GTTTCAGGCGATGACATCAC -> TTTCAGGCGATGACATCACA
CAATGGTACGGCTAAACTAT -> AATGGTACGGCTAAACTATG
GTATTTTCAACCGCACCTGA -> TATTTTCAACCGCACCTGAA
CAATAATTCCACGTAATACC -> AATAATTCCACGTAATACCG
TCGAGGGGTTTGCGAGGTGC -> CGAGGGGTTTGCGAGGTGCA
GAGGTGCACGCTAGTGTAGA -> AGGTGCACGCTAGTGTAGAG
ATTGGCAGTCCTGTGAACAA -> TTGGCAGTCCTGTGAACAAT
AAGCCCAGTAAATCGATGGG -> AGCCCAGTAAATCGATGGGC
GTCGCAACTTAGTCCTTCCC -> TCGCAACTTAGTCCTTCCCA
AAGGATAACGGAATGCGAAG -> AGGATAACGGAATGCGAAGG
CGATTCACCGCATAGAGTCT -> GATTCACCGCATAGAGTCTA
CCGCATAGAGTCTAATCCCC -> CGCATAGAGTCTAATCCCCG
TAGTTTCAGGCGATGACATC -> AGTTTCAGGCGATGACATCA
ATGACGATGAGCTGTATCTC -> TGACGATGAGCTGTATCTCG
TGTGAACAATTTCCTGACGC -> GTGAACAATTTCCTGACGCT
TTTTCAACCGCACCTGAACG -> TTTCAACCGCACCTGAACGA
TCTGGGTCGGGGATTCTCGA -> CTGGGTCGGGGATTCTCGAT
CCAGTAAATCGATGGGCACG -> CAGTAAATCGATGGGCACGC
CCAGTTGCTCCACAAAATCG -> CAGTTGCTCCACAAAATCGT
TGGATCATCACTGGTCATTT -> GGATCATCACTGGTCATTTC
TTGGCAGTCCTGTGAACAAT -> TGGCAGTCCTGTGAACAATT
CCACGATATTGCGAAGCCCA -> CACGATATTGCGAAGCCCAG
TACTTCGTAAACAAAAATGT -> ACTTCGTAAACAAAAATGTC
ATAATTCCACGTAATACCGC -> TAATTCCACGTAATACCGCC
GTAAACAAAAATGTCGTCCG -> TAAACAAAAATGTCGTCCGA
ATCGTAGCTTCGGTCCCCGA -> TCGTAGCTTCGGTCCCCGAC
CTCCCCACGATATTGCGAAG -> TCCCCACGATATTGCGAAGC
CAGGCGATGACATCACAGGA -> AGGCGATGACATCACAGGAT
GACGCTGGCTGTCGAATAAT -> ACGCTGGCTGTCGAATAATA
GCTGCTCTTTCGAATCAGAC -> CTGCTCTTTCGAATCAGACT
CTTGTGCAGTGGAGGTATTT -> TTGTGCAGTGGAGGTATTTT
GTCGAATAATAACCAAGAAG -> TCGAATAATAACCAAGAAGC
TTCTACACAGATTGGCAGTC -> TCTACACAGATTGGCAGTCC
TAAACTATGACGATGAGCTG -> AAACTATGACGATGAGCTGT
TAGTGTTCTCGGATCTAACT -> AGTGTTCTCGGATCTAACTA
ACGGCTAAACTATGACGATG -> CGGCTAAACTATGACGATGA
TACAAGCTCGCCGAAAGGGG -> ACAAGCTCGCCGAAAGGGGC
GTATCTCGAGGGGTTTGCGA -> TATCTCGAGGGGTTTGCGAG
GCAGACTCTCCAGAGAGGAA -> CAGACTCTCCAGAGAGGAAG
ATCACTGGTCATTTCTACAC -> TCACTGGTCATTTCTACACA
ACGGAATGCGAAGGCGATAA -> CGGAATGCGAAGGCGATAAT
TCCCATGACGGAAACTGCTG -> CCCATGACGGAAACTGCTGT
TTTCAACCGCACCTGAACGA -> TTCAACCGCACCTGAACGAT
TTGATAACGCGCCAGTGTGG -> TGATAACGCGCCAGTGTGGT
CGGCGCTCAGCGCTGACGTC -> GGCGCTCAGCGCTGACGTCT
TCGAATCAGACTTACGGCGC -> CGAATCAGACTTACGGCGCT
GTGTCTTCAAATGGCTCATC -> TGTCTTCAAATGGCTCATCA
CAAGAGTTGGGTGGATCATC -> AAGAGTTGGGTGGATCATCA
TCACTGGTCATTTCTACACA -> CACTGGTCATTTCTACACAG
CTGTGAACAATTTCCTGACG -> TGTGAACAATTTCCTGACGC
TCTAACTAGGAGGCACCCCG -> CTAACTAGGAGGCACCCCGA
CCTTTGACGGTGAGCCGCTA -> CTTTGACGGTGAGCCGCTAA
GTGTAGAGTAAGCAAGGATA -> TGTAGAGTAAGCAAGGATAA
CAAGGATAACGGAATGCGAA -> AAGGATAACGGAATGCGAAG
CACGTAATACCGCCGACTAT -> ACGTAATACCGCCGACTATT
GGAATGCGAAGGCGATAATC -> GAATGCGAAGGCGATAATCC
CCGATTCACCGCATAGAGTC -> CGATTCACCGCATAGAGTCT
TGCTCTTTCGAATCAGACTT -> GCTCTTTCGAATCAGACTTA
GGCAGACTCTCCAGAGAGGA -> GCAGACTCTCCAGAGAGGAA
ACTCGCCACGCAAGAGTTGG -> CTCGCCACGCAAGAGTTGGG
TCATTTCTACACAGATTGGC -> CATTTCTACACAGATTGGCA
TTCGTAAACAAAAATGTCGT -> TCGTAAACAAAAATGTCGTC
GTGTTCTCGGATCTAACTAG -> TGTTCTCGGATCTAACTAGG
AGGTGTACAAAAGAGGGCCG -> GGTGTACAAAAGAGGGCCGA
CAAAAATGTCGTCCGATAGG -> AAAAATGTCGTCCGATAGGG
CGATGGGCACGCGGAGAGGC -> GATGGGCACGCGGAGAGGCG
TCGTAAACAAAAATGTCGTC -> CGTAAACAAAAATGTCGTCC
AGGATAGATCTGGGTCGGGG -> GGATAGATCTGGGTCGGGGA
CTCTAGCTGCTCTTTCGAAT -> TCTAGCTGCTCTTTCGAATC
TAGGACCGTTCCTCGCAAAT -> AGGACCGTTCCTCGCAAATC
TCAGCGCTGACGTCTACTTA -> CAGCGCTGACGTCTACTTAG
AAAGAGGGCCGACAACAAAA -> AAGAGGGCCGACAACAAAAC
AAACACCGCACTGACGCTGT -> AACACCGCACTGACGCTGTT
CCTTCCCATGACGGAAACTG -> CTTCCCATGACGGAAACTGC
CTAACTAGGAGGCACCCCGA -> TAACTAGGAGGCACCCCGAT
CTGAACGATCATTGGTGTAC -> TGAACGATCATTGGTGTACT
GGTGTACAAAAGAGGGCCGA -> GTGTACAAAAGAGGGCCGAC
ACGCGTCGCAACTTAGTCCT -> CGCGTCGCAACTTAGTCCTT
GAATGCGAAGGCGATAATCC -> AATGCGAAGGCGATAATCCA
TGTCGAATAATAACCAAGAA -> GTCGAATAATAACCAAGAAG
TTGCTCCACAAAATCGTAGC -> TGCTCCACAAAATCGTAGCT
CGCTGGCTGTCGAATAATAA -> GCTGGCTGTCGAATAATAAC
CGGGGATTCTCGATGAATAC -> GGGGATTCTCGATGAATACA
GGTCATTTCTACACAGATTG -> GTCATTTCTACACAGATTGG
ATTTTCAACCGCACCTGAAC -> TTTTCAACCGCACCTGAACG
GAAGCCCAGTAAATCGATGG -> AAGCCCAGTAAATCGATGGG
GACCGTTCCTCGCAAATCGT -> ACCGTTCCTCGCAAATCGTG
GCGCTCAGCGCTGACGTCTA -> CGCTCAGCGCTGACGTCTAC
TATTCGGCAGACTCTCCAGA -> ATTCGGCAGACTCTCCAGAG
CCACGCAAGAGTTGGGTGGA -> CACGCAAGAGTTGGGTGGAT
TTGGGTGGATCATCACTGGT -> TGGGTGGATCATCACTGGTC
AGGAGGCACCCCGATTCACC -> GGAGGCACCCCGATTCACCG
ATACTCTAGCTGCTCTTTCG -> TACTCTAGCTGCTCTTTCGA
TAGGTCCTCCCCACGATATT -> AGGTCCTCCCCACGATATTG
GATATTGCGAAGCCCAGTAA -> ATATTGCGAAGCCCAGTAAA
AGGCGATAATCCAGTAAGTA -> GGCGATAATCCAGTAAGTAA
AGTCTAATCCCCGACTTACG -> GTCTAATCCCCGACTTACGC
TTTGACGGTGAGCCGCTAAT -> TTGACGGTGAGCCGCTAATG
TTACATTCGCTGAGGTACGG -> TACATTCGCTGAGGTACGGC
CAATTTCCTGACGCTGGCTG -> AATTTCCTGACGCTGGCTGT
CCGACTCGATTTTTACATTC -> CGACTCGATTTTTACATTCA
TACGCGTCGCAACTTAGTCC -> ACGCGTCGCAACTTAGTCCT
TTCGCTGAGGTACGGCGCTC -> TCGCTGAGGTACGGCGCTCA
CATTCAATGGTACGGCTAAA -> ATTCAATGGTACGGCTAAAC
GCTGTTACAAGTCGAACGCT -> CTGTTACAAGTCGAACGCTC
GCGATAATCCAGTAAGTAAG -> CGATAATCCAGTAAGTAAGT
CGGCTAGGTCCTCCCCACGA -> GGCTAGGTCCTCCCCACGAT
TGTGGTTCACTCGCCACGCA -> GTGGTTCACTCGCCACGCAA
AAAAATGTCGTCCGATAGGG -> AAAATGTCGTCCGATAGGGG
TTCAATGGTACGGCTAAACT -> TCAATGGTACGGCTAAACTA
ACTGCTGTTACAAGTCGAAC -> CTGCTGTTACAAGTCGAACG
CGCATAGAGTCTAATCCCCG -> GCATAGAGTCTAATCCCCGA
CTGGCTGTCGAATAATAACC -> TGGCTGTCGAATAATAACCA
CGATTTTTACATTCAATGGT -> GATTTTTACATTCAATGGTA
CAGCGCTGACGTCTACTTAG -> AGCGCTGACGTCTACTTAGC
AACTTAGTCCTTCCCATGAC -> ACTTAGTCCTTCCCATGACG
CGGTCCCCGACTCGATTTTT -> GGTCCCCGACTCGATTTTTA
GTCGTCCGATAGGGGACTGC -> TCGTCCGATAGGGGACTGCC
GCTCTTTCGAATCAGACTTA -> CTCTTTCGAATCAGACTTAC
AACACCGCACTGACGCTGTT -> ACACCGCACTGACGCTGTTA
TTAGTCCTTCCCATGACGGA -> TAGTCCTTCCCATGACGGAA
AACCCCGGGCTAGTGTTCTC -> ACCCCGGGCTAGTGTTCTCG
TTCGGCAGACTCTCCAGAGA -> TCGGCAGACTCTCCAGAGAG
ATAGTGTTACATTCGCTGAG -> TAGTGTTACATTCGCTGAGG
TCGGGGATTCTCGATGAATA -> CGGGGATTCTCGATGAATAC
GGAGGCACCCCGATTCACCG -> GAGGCACCCCGATTCACCGC
ACTAGGAGGCACCCCGATTC -> CTAGGAGGCACCCCGATTCA
TAAATCGATGGGCACGCGGA -> AAATCGATGGGCACGCGGAG
GACGGGGATGCCCGCTCCTA -> ACGGGGATGCCCGCTCCTAC
ACTCTAGCTGCTCTTTCGAA -> CTCTAGCTGCTCTTTCGAAT
GGCTAAACTATGACGATGAG -> GCTAAACTATGACGATGAGC
CGATATTGCGAAGCCCAGTA -> GATATTGCGAAGCCCAGTAA
GCTGTCGAATAATAACCAAG -> CTGTCGAATAATAACCAAGA
CAAAATCGTAGCTTCGGTCC -> AAAATCGTAGCTTCGGTCCC
AATCGATGGGCACGCGGAGA -> ATCGATGGGCACGCGGAGAG
GTGTACTATACTCTAGCTGC -> TGTACTATACTCTAGCTGCT
CGCTAGTGTAGAGTAAGCAA -> GCTAGTGTAGAGTAAGCAAG
ATTGCGAAGCCCAGTAAATC -> TTGCGAAGCCCAGTAAATCG
TAGATCTGGGTCGGGGATTC -> AGATCTGGGTCGGGGATTCT
TAACGGAATGCGAAGGCGAT -> AACGGAATGCGAAGGCGATA
ACTTACGGCGCTAAACACCG -> CTTACGGCGCTAAACACCGC
GGTACGGCGCTCAGCGCTGA -> GTACGGCGCTCAGCGCTGAC
GTGAACAATTTCCTGACGCT -> TGAACAATTTCCTGACGCTG
AATTAGTAATCTTGTGCAGT -> ATTAGTAATCTTGTGCAGTG
CTGGGTCGGGGATTCTCGAT -> TGGGTCGGGGATTCTCGATG
TGGGTCGGGGATTCTCGATG -> GGGTCGGGGATTCTCGATGA
GAGGAAGGTGTACAAAAGAG -> AGGAAGGTGTACAAAAGAGG
CACGCAAGAGTTGGGTGGAT -> ACGCAAGAGTTGGGTGGATC
AGACTCTCCAGAGAGGAAGG -> GACTCTCCAGAGAGGAAGGT
CGCACCTGAACGATCATTGG -> GCACCTGAACGATCATTGGT
CTCTCCAGAGAGGAAGGTGT -> TCTCCAGAGAGGAAGGTGTA
ACCTGAACGATCATTGGTGT -> CCTGAACGATCATTGGTGTA
ATCCTTTGACGGTGAGCCGC -> TCCTTTGACGGTGAGCCGCT
GGGCTAGTGTTCTCGGATCT -> GGCTAGTGTTCTCGGATCTA
CCTCCCCACGATATTGCGAA -> CTCCCCACGATATTGCGAAG
ACTTAGTCCTTCCCATGACG -> CTTAGTCCTTCCCATGACGG
CGAGGGGTTTGCGAGGTGCA -> GAGGGGTTTGCGAGGTGCAC
CGCTCCGGCTAGGTCCTCCC -> GCTCCGGCTAGGTCCTCCCC
ATCCCCGACTTACGCGTCGC -> TCCCCGACTTACGCGTCGCA
CACCCCGATTCACCGCATAG -> ACCCCGATTCACCGCATAGA
TGCCCCTTGATAACGCGCCA -> GCCCCTTGATAACGCGCCAG
GCCGAAAGGGGCCTTTACTT -> CCGAAAGGGGCCTTTACTTC
AGAGAGGAAGGTGTACAAAA -> GAGAGGAAGGTGTACAAAAG
GTGGTTCACTCGCCACGCAA -> TGGTTCACTCGCCACGCAAG
GGCGATAATCCAGTAAGTAA -> GCGATAATCCAGTAAGTAAG
GGCGATGACATCACAGGATA -> GCGATGACATCACAGGATAG
CGCCACGCAAGAGTTGGGTG -> GCCACGCAAGAGTTGGGTGG
TGTGTCTTCAAATGGCTCAT -> GTGTCTTCAAATGGCTCATC
CTGTTACAAGTCGAACGCTC -> TGTTACAAGTCGAACGCTCC
AGGACCGTTCCTCGCAAATC -> GGACCGTTCCTCGCAAATCG
CTAGAGACGGGGATGCCCGC -> TAGAGACGGGGATGCCCGCT
CCCATGACGGAAACTGCTGT -> CCATGACGGAAACTGCTGTT
GGGTCGGGGATTCTCGATGA -> GGTCGGGGATTCTCGATGAA
TGCGAAGGCGATAATCCAGT -> GCGAAGGCGATAATCCAGTA
CATTTCTACACAGATTGGCA -> ATTTCTACACAGATTGGCAG
TTTGCGAGGTGCACGCTAGT -> TTGCGAGGTGCACGCTAGTG
CTTTACTTCGTAAACAAAAA -> TTTACTTCGTAAACAAAAAT
ACATCACAGGATAGATCTGG -> CATCACAGGATAGATCTGGG
TGTAGGACCGTTCCTCGCAA -> GTAGGACCGTTCCTCGCAAA
GCGTCGCAACTTAGTCCTTC -> CGTCGCAACTTAGTCCTTCC
ATAATAACCAAGAAGCTAGA -> TAATAACCAAGAAGCTAGAG
AATCTTGTGCAGTGGAGGTA -> ATCTTGTGCAGTGGAGGTAT
AAATCGTAGCTTCGGTCCCC -> AATCGTAGCTTCGGTCCCCG
ATTGGTGTACTATACTCTAG -> TTGGTGTACTATACTCTAGC
CATGACGGAAACTGCTGTTA -> ATGACGGAAACTGCTGTTAC
GCCCAGTAAATCGATGGGCA -> CCCAGTAAATCGATGGGCAC
AAACAAAAATGTCGTCCGAT -> AACAAAAATGTCGTCCGATA
GGTGAGCCGCTAATGCCCCT -> GTGAGCCGCTAATGCCCCTT
TCGTCCGATAGGGGACTGCC -> CGTCCGATAGGGGACTGCCA
GCTCCTACAATAATTCCACG -> CTCCTACAATAATTCCACGT
TCCCCGACTCGATTTTTACA -> CCCCGACTCGATTTTTACAT
CTGAGGTACGGCGCTCAGCG -> TGAGGTACGGCGCTCAGCGC
ATTTTTACATTCAATGGTAC -> TTTTTACATTCAATGGTACG
CTAGCTGCTCTTTCGAATCA -> TAGCTGCTCTTTCGAATCAG
CGCTAAACACCGCACTGACG -> GCTAAACACCGCACTGACGC
TAATCTTGTGCAGTGGAGGT -> AATCTTGTGCAGTGGAGGTA
TTCAAATGGCTCATCAATGT -> TCAAATGGCTCATCAATGTT
TTCCTCGCAAATCGTGGCCT -> TCCTCGCAAATCGTGGCCTA
TCCTCCCCACGATATTGCGA -> CCTCCCCACGATATTGCGAA
GTAAGCAAGGATAACGGAAT -> TAAGCAAGGATAACGGAATG
GTAATCTTGTGCAGTGGAGG -> TAATCTTGTGCAGTGGAGGT
CCGGCTAGGTCCTCCCCACG -> CGGCTAGGTCCTCCCCACGA
ACACGCTCTGTGTAGGACCG -> CACGCTCTGTGTAGGACCGT
CCCGACTTACGCGTCGCAAC -> CCGACTTACGCGTCGCAACT
GCTCCGGCTAGGTCCTCCCC -> CTCCGGCTAGGTCCTCCCCA
GTAGGACCGTTCCTCGCAAA -> TAGGACCGTTCCTCGCAAAT
GTAGTTTCAGGCGATGACAT -> TAGTTTCAGGCGATGACATC
TCGATGAATACACGCTCTGT -> CGATGAATACACGCTCTGTG
ACACAGATTGGCAGTCCTGT -> CACAGATTGGCAGTCCTGTG
TCATCAATGTTGCAGACCCA -> CATCAATGTTGCAGACCCAA
CGCTGACGTCTACTTAGCCA -> GCTGACGTCTACTTAGCCAG
AACGATCATTGGTGTACTAT -> ACGATCATTGGTGTACTATA
TCCCCACGATATTGCGAAGC -> CCCCACGATATTGCGAAGCC
ATTCTCGATGAATACACGCT -> TTCTCGATGAATACACGCTC
TGACGATGAGCTGTATCTCG -> GACGATGAGCTGTATCTCGA
GTCATTTCTACACAGATTGG -> TCATTTCTACACAGATTGGC
ACGTCTACTTAGCCAGTTGC -> CGTCTACTTAGCCAGTTGCT
AATACACGCTCTGTGTAGGA -> ATACACGCTCTGTGTAGGAC
GGAAACTGCTGTTACAAGTC -> GAAACTGCTGTTACAAGTCG
TGTACAAAAGAGGGCCGACA -> GTACAAAAGAGGGCCGACAA
TGTATCTCGAGGGGTTTGCG -> GTATCTCGAGGGGTTTGCGA
CATTGGTGTACTATACTCTA -> ATTGGTGTACTATACTCTAG
AACGCTCCGGCTAGGTCCTC -> ACGCTCCGGCTAGGTCCTCC
ATACACGCTCTGTGTAGGAC -> TACACGCTCTGTGTAGGACC
TAATAACCAAGAAGCTAGAG -> AATAACCAAGAAGCTAGAGA
GCTGAGGTACGGCGCTCAGC -> CTGAGGTACGGCGCTCAGCG
GCATCCTTTGACGGTGAGCC -> CATCCTTTGACGGTGAGCCG
ACCCAATTAGTAATCTTGTG -> CCCAATTAGTAATCTTGTGC
ATCATTGGTGTACTATACTC -> TCATTGGTGTACTATACTCT
GCCGCTAATGCCCCTTGATA -> CCGCTAATGCCCCTTGATAA
TAATGCCCCTTGATAACGCG -> AATGCCCCTTGATAACGCGC
CAGTGGAGGTATTTTCAACC -> AGTGGAGGTATTTTCAACCG
AAGGGGCCTTTACTTCGTAA -> AGGGGCCTTTACTTCGTAAA
CCACAAAATCGTAGCTTCGG -> CACAAAATCGTAGCTTCGGT
TAGCTGCTCTTTCGAATCAG -> AGCTGCTCTTTCGAATCAGA
GATTGGCAGTCCTGTGAACA -> ATTGGCAGTCCTGTGAACAA
GGCTAGGTCCTCCCCACGAT -> GCTAGGTCCTCCCCACGATA
ACCGCCGACTATTCGGCAGA -> CCGCCGACTATTCGGCAGAC
GCCGACAACAAAACCCCGGG -> CCGACAACAAAACCCCGGGC
CGAAGGCGATAATCCAGTAA -> GAAGGCGATAATCCAGTAAG
CGTCCGATAGGGGACTGCCA -> GTCCGATAGGGGACTGCCAG
TCCAGAGAGGAAGGTGTACA -> CCAGAGAGGAAGGTGTACAA
GCTGTATCTCGAGGGGTTTG -> CTGTATCTCGAGGGGTTTGC
TCCGATAGGGGACTGCCAGT -> CCGATAGGGGACTGCCAGTA
CGATGAGCTGTATCTCGAGG -> GATGAGCTGTATCTCGAGGG
GTGGATCATCACTGGTCATT -> TGGATCATCACTGGTCATTT
AAGCTCGCCGAAAGGGGCCT -> AGCTCGCCGAAAGGGGCCTT
CGTCTACTTAGCCAGTTGCT -> GTCTACTTAGCCAGTTGCTC
CTCTTTCGAATCAGACTTAC -> TCTTTCGAATCAGACTTACG
CGTGGCCTACAAGCTCGCCG -> GTGGCCTACAAGCTCGCCGA
ACGGAAACTGCTGTTACAAG -> CGGAAACTGCTGTTACAAGT
AGAGGAAGGTGTACAAAAGA -> GAGGAAGGTGTACAAAAGAG
GCTAGTGTAGAGTAAGCAAG -> CTAGTGTAGAGTAAGCAAGG
CCTCGCAAATCGTGGCCTAC -> CTCGCAAATCGTGGCCTACA
TCGTAGCTTCGGTCCCCGAC -> CGTAGCTTCGGTCCCCGACT
TGCCCGCTCCTACAATAATT -> GCCCGCTCCTACAATAATTC
CGCGTCGCAACTTAGTCCTT -> GCGTCGCAACTTAGTCCTTC
CGTTCCTCGCAAATCGTGGC -> GTTCCTCGCAAATCGTGGCC
CCAATTAGTAATCTTGTGCA -> CAATTAGTAATCTTGTGCAG
CGCACTTGTGTCTTCAAATG -> GCACTTGTGTCTTCAAATGG
TACACGCTCTGTGTAGGACC -> ACACGCTCTGTGTAGGACCG
ACCCCGGGCTAGTGTTCTCG -> CCCCGGGCTAGTGTTCTCGG
ATCTGGGTCGGGGATTCTCG -> TCTGGGTCGGGGATTCTCGA
AACAAAACCCCGGGCTAGTG -> ACAAAACCCCGGGCTAGTGT
ACGCTAGTGTAGAGTAAGCA -> CGCTAGTGTAGAGTAAGCAA
GGGGATGCCCGCTCCTACAA -> GGGATGCCCGCTCCTACAAT
ATCGTGGCCTACAAGCTCGC -> TCGTGGCCTACAAGCTCGCC
TGCGAAGCCCAGTAAATCGA -> GCGAAGCCCAGTAAATCGAT
TGGCTCATCAATGTTGCAGA -> GGCTCATCAATGTTGCAGAC
CTAAACTATGACGATGAGCT -> TAAACTATGACGATGAGCTG
GCATAGAGTCTAATCCCCGA -> CATAGAGTCTAATCCCCGAC
CTGACGCTGTTACCGCTTAT -> TGACGCTGTTACCGCTTATA
AACCAAGAAGCTAGAGACGG -> ACCAAGAAGCTAGAGACGGG
TAAGCAAGGATAACGGAATG -> AAGCAAGGATAACGGAATGC
CGTAGCTTCGGTCCCCGACT -> GTAGCTTCGGTCCCCGACTC
AGTCCTGTGAACAATTTCCT -> GTCCTGTGAACAATTTCCTG
TGACATCACAGGATAGATCT -> GACATCACAGGATAGATCTG
AGGTATTTTCAACCGCACCT -> GGTATTTTCAACCGCACCTG
TCTACACAGATTGGCAGTCC -> CTACACAGATTGGCAGTCCT
TACTTAGCCAGTTGCTCCAC -> ACTTAGCCAGTTGCTCCACA
ACGTAATACCGCCGACTATT -> CGTAATACCGCCGACTATTC
GAGAGGCGCACTTGTGTCTT -> AGAGGCGCACTTGTGTCTTC
GGAGGTATTTTCAACCGCAC -> GAGGTATTTTCAACCGCACC
CACCTGAACGATCATTGGTG -> ACCTGAACGATCATTGGTGT
TTCGAATCAGACTTACGGCG -> TCGAATCAGACTTACGGCGC
CGACTCGATTTTTACATTCA -> GACTCGATTTTTACATTCAA
GCTCAGCGCTGACGTCTACT -> CTCAGCGCTGACGTCTACTT
TACACAGATTGGCAGTCCTG -> ACACAGATTGGCAGTCCTGT
TTCAACCGCACCTGAACGAT -> TCAACCGCACCTGAACGATC
GGCGCTAAACACCGCACTGA -> GCGCTAAACACCGCACTGAC
ACTCTCCAGAGAGGAAGGTG -> CTCTCCAGAGAGGAAGGTGT
TCCTGACGCTGGCTGTCGAA -> CCTGACGCTGGCTGTCGAAT
GATTTTTACATTCAATGGTA -> ATTTTTACATTCAATGGTAC
AATACCGCCGACTATTCGGC -> ATACCGCCGACTATTCGGCA
GGCAGTCCTGTGAACAATTT -> GCAGTCCTGTGAACAATTTC
CGCACTGACGCTGTTACCGC -> GCACTGACGCTGTTACCGCT
CGCTGAGGTACGGCGCTCAG -> GCTGAGGTACGGCGCTCAGC
CACGCTAGTGTAGAGTAAGC -> ACGCTAGTGTAGAGTAAGCA
CGATCATTGGTGTACTATAC -> GATCATTGGTGTACTATACT
TATAGTGTTACATTCGCTGA -> ATAGTGTTACATTCGCTGAG
CCGCTTATAGTGTTACATTC -> CGCTTATAGTGTTACATTCG
AGTAAGTAGTTTCAGGCGAT -> GTAAGTAGTTTCAGGCGATG
GTCGAACGCTCCGGCTAGGT -> TCGAACGCTCCGGCTAGGTC
AGCTGCTCTTTCGAATCAGA -> GCTGCTCTTTCGAATCAGAC
AGTGTTCTCGGATCTAACTA -> GTGTTCTCGGATCTAACTAG
AATGGCTCATCAATGTTGCA -> ATGGCTCATCAATGTTGCAG
GCGCTGACGTCTACTTAGCC -> CGCTGACGTCTACTTAGCCA
ATGCCCCTTGATAACGCGCC -> TGCCCCTTGATAACGCGCCA
TAGCCAGTTGCTCCACAAAA -> AGCCAGTTGCTCCACAAAAT
TCGCAACTTAGTCCTTCCCA -> CGCAACTTAGTCCTTCCCAT
TCACCGCATAGAGTCTAATC -> CACCGCATAGAGTCTAATCC
CCTACAAGCTCGCCGAAAGG -> CTACAAGCTCGCCGAAAGGG
GTAAGTAAGTAGTTTCAGGC -> TAAGTAAGTAGTTTCAGGCG
GCAAGAGTTGGGTGGATCAT -> CAAGAGTTGGGTGGATCATC
CGAACGCTCCGGCTAGGTCC -> GAACGCTCCGGCTAGGTCCT
GCTAATGCCCCTTGATAACG -> CTAATGCCCCTTGATAACGC
CTCGGATCTAACTAGGAGGC -> TCGGATCTAACTAGGAGGCA
GACTCTCCAGAGAGGAAGGT -> ACTCTCCAGAGAGGAAGGTG
TTTACTTCGTAAACAAAAAT -> TTACTTCGTAAACAAAAATG
GACTCGATTTTTACATTCAA -> ACTCGATTTTTACATTCAAT
CTAATCCCCGACTTACGCGT -> TAATCCCCGACTTACGCGTC
CCTGAACGATCATTGGTGTA -> CTGAACGATCATTGGTGTAC
CTAGTGTAGAGTAAGCAAGG -> TAGTGTAGAGTAAGCAAGGA
ATAGATCTGGGTCGGGGATT -> TAGATCTGGGTCGGGGATTC
TCTGTGTAGGACCGTTCCTC -> CTGTGTAGGACCGTTCCTCG
ACCCCGATTCACCGCATAGA -> CCCCGATTCACCGCATAGAG
CAATTAGTAATCTTGTGCAG -> AATTAGTAATCTTGTGCAGT
ACACCGCACTGACGCTGTTA -> CACCGCACTGACGCTGTTAC
CCGATAGGGGACTGCCAGTA -> CGATAGGGGACTGCCAGTAA
CATCACTGGTCATTTCTACA -> ATCACTGGTCATTTCTACAC
ACTATTCGGCAGACTCTCCA -> CTATTCGGCAGACTCTCCAG
CCCACGATATTGCGAAGCCC -> CCACGATATTGCGAAGCCCA
GGTGGATCATCACTGGTCAT -> GTGGATCATCACTGGTCATT
GGATAACGGAATGCGAAGGC -> GATAACGGAATGCGAAGGCG
TTCTCGATGAATACACGCTC -> TCTCGATGAATACACGCTCT
GATTCTCGATGAATACACGC -> ATTCTCGATGAATACACGCT
ACCAAGAAGCTAGAGACGGG -> CCAAGAAGCTAGAGACGGGG
AGCTAGAGACGGGGATGCCC -> GCTAGAGACGGGGATGCCCG
CACTTGTGTCTTCAAATGGC -> ACTTGTGTCTTCAAATGGCT
CTGCTGTTACAAGTCGAACG -> TGCTGTTACAAGTCGAACGC
AAATCGTGGCCTACAAGCTC -> AATCGTGGCCTACAAGCTCG
GGCCGACAACAAAACCCCGG -> GCCGACAACAAAACCCCGGG
CTCTGTGTAGGACCGTTCCT -> TCTGTGTAGGACCGTTCCTC
GATAACGGAATGCGAAGGCG -> ATAACGGAATGCGAAGGCGA
AGGTGCACGCTAGTGTAGAG -> GGTGCACGCTAGTGTAGAGT
TTACATTCAATGGTACGGCT -> TACATTCAATGGTACGGCTA
AAGGCGATAATCCAGTAAGT -> AGGCGATAATCCAGTAAGTA
GCCCGCTCCTACAATAATTC -> CCCGCTCCTACAATAATTCC
GGTCCCCGACTCGATTTTTA -> GTCCCCGACTCGATTTTTAC
GTCCTGTGAACAATTTCCTG -> TCCTGTGAACAATTTCCTGA
AGAGACGGGGATGCCCGCTC -> GAGACGGGGATGCCCGCTCC
ATTAGTAATCTTGTGCAGTG -> TTAGTAATCTTGTGCAGTGG
TCCACAAAATCGTAGCTTCG -> CCACAAAATCGTAGCTTCGG
AGGCGATGACATCACAGGAT -> GGCGATGACATCACAGGATA
CTTCGGTCCCCGACTCGATT -> TTCGGTCCCCGACTCGATTT
GAGTCTAATCCCCGACTTAC -> AGTCTAATCCCCGACTTACG
CTGTCGAATAATAACCAAGA -> TGTCGAATAATAACCAAGAA
AGAGTCTAATCCCCGACTTA -> GAGTCTAATCCCCGACTTAC
AATCCAGTAAGTAAGTAGTT -> ATCCAGTAAGTAAGTAGTTT
TTGCGAGGTGCACGCTAGTG -> TGCGAGGTGCACGCTAGTGT
GTAAGTAGTTTCAGGCGATG -> TAAGTAGTTTCAGGCGATGA
CTTAGCCAGTTGCTCCACAA -> TTAGCCAGTTGCTCCACAAA
TTTCTACACAGATTGGCAGT -> TTCTACACAGATTGGCAGTC
TCTACTTAGCCAGTTGCTCC -> CTACTTAGCCAGTTGCTCCA
ACGCTGTTACCGCTTATAGT -> CGCTGTTACCGCTTATAGTG
ATGTTGCAGACCCAATTAGT -> TGTTGCAGACCCAATTAGTA
GAGAGGAAGGTGTACAAAAG -> AGAGGAAGGTGTACAAAAGA
GGGCCTTTACTTCGTAAACA -> GGCCTTTACTTCGTAAACAA
TCCTTTGACGGTGAGCCGCT -> CCTTTGACGGTGAGCCGCTA
CGCAAATCGTGGCCTACAAG -> GCAAATCGTGGCCTACAAGC
GAATACACGCTCTGTGTAGG -> AATACACGCTCTGTGTAGGA
CCTGTGAACAATTTCCTGAC -> CTGTGAACAATTTCCTGACG
GGATCTAACTAGGAGGCACC -> GATCTAACTAGGAGGCACCC
ATTTCTACACAGATTGGCAG -> TTTCTACACAGATTGGCAGT
TACGGCGCTCAGCGCTGACG -> ACGGCGCTCAGCGCTGACGT
AAATGTCGTCCGATAGGGGA -> AATGTCGTCCGATAGGGGAC
GACCCAATTAGTAATCTTGT -> ACCCAATTAGTAATCTTGTG
AAAGGGGCCTTTACTTCGTA -> AAGGGGCCTTTACTTCGTAA
CTGTGTAGGACCGTTCCTCG -> TGTGTAGGACCGTTCCTCGC
TGTGCAGTGGAGGTATTTTC -> GTGCAGTGGAGGTATTTTCA
ACAAAAGAGGGCCGACAACA -> CAAAAGAGGGCCGACAACAA
AATAATAACCAAGAAGCTAG -> ATAATAACCAAGAAGCTAGA
TAACGCGCCAGTGTGGTTCA -> AACGCGCCAGTGTGGTTCAC
GAGCCGCTAATGCCCCTTGA -> AGCCGCTAATGCCCCTTGAT
TGGGCACGCGGAGAGGCGCA -> GGGCACGCGGAGAGGCGCAC
ATGACGGAAACTGCTGTTAC -> TGACGGAAACTGCTGTTACA
TCGCCACGCAAGAGTTGGGT -> CGCCACGCAAGAGTTGGGTG
ACTATGACGATGAGCTGTAT -> CTATGACGATGAGCTGTATC
GCTCTGTGTAGGACCGTTCC -> CTCTGTGTAGGACCGTTCCT
CAAGCTCGCCGAAAGGGGCC -> AAGCTCGCCGAAAGGGGCCT
GTTGCAGACCCAATTAGTAA -> TTGCAGACCCAATTAGTAAT
GCCAGTGTGGTTCACTCGCC -> CCAGTGTGGTTCACTCGCCA
CTCGCAAATCGTGGCCTACA -> TCGCAAATCGTGGCCTACAA
CGGATCTAACTAGGAGGCAC -> GGATCTAACTAGGAGGCACC
CACGCTCTGTGTAGGACCGT -> ACGCTCTGTGTAGGACCGTT
ACGATCATTGGTGTACTATA -> CGATCATTGGTGTACTATAC
CGACTATTCGGCAGACTCTC -> GACTATTCGGCAGACTCTCC
GTTGGGTGGATCATCACTGG -> TTGGGTGGATCATCACTGGT
TGGGTGGATCATCACTGGTC -> GGGTGGATCATCACTGGTCA
CCCCGATTCACCGCATAGAG -> CCCGATTCACCGCATAGAGT
GATGACATCACAGGATAGAT -> ATGACATCACAGGATAGATC
CTCGATTTTTACATTCAATG -> TCGATTTTTACATTCAATGG
AGTGTTACATTCGCTGAGGT -> GTGTTACATTCGCTGAGGTA
CCGCTCCTACAATAATTCCA -> CGCTCCTACAATAATTCCAC
AAGAGTTGGGTGGATCATCA -> AGAGTTGGGTGGATCATCAC
AGTAGTTTCAGGCGATGACA -> GTAGTTTCAGGCGATGACAT
TACATTCGCTGAGGTACGGC -> ACATTCGCTGAGGTACGGCG
TTCCACGTAATACCGCCGAC -> TCCACGTAATACCGCCGACT
GTCGGGGATTCTCGATGAAT -> TCGGGGATTCTCGATGAATA
CGGCAGACTCTCCAGAGAGG -> GGCAGACTCTCCAGAGAGGA
TCGTGGCCTACAAGCTCGCC -> CGTGGCCTACAAGCTCGCCG
AATCCCCGACTTACGCGTCG -> ATCCCCGACTTACGCGTCGC
GCCCCTTGATAACGCGCCAG -> CCCCTTGATAACGCGCCAGT
GATCATTGGTGTACTATACT -> ATCATTGGTGTACTATACTC
ATGTCGTCCGATAGGGGACT -> TGTCGTCCGATAGGGGACTG
TGACGTCTACTTAGCCAGTT -> GACGTCTACTTAGCCAGTTG
GGTCCTCCCCACGATATTGC -> GTCCTCCCCACGATATTGCG
ACGCTCCGGCTAGGTCCTCC -> CGCTCCGGCTAGGTCCTCCC
GCCAGTTGCTCCACAAAATC -> CCAGTTGCTCCACAAAATCG
AACGCGCCAGTGTGGTTCAC -> ACGCGCCAGTGTGGTTCACT
CCGAAAGGGGCCTTTACTTC -> CGAAAGGGGCCTTTACTTCG
CTACAATAATTCCACGTAAT -> TACAATAATTCCACGTAATA
CGGCTAAACTATGACGATGA -> GGCTAAACTATGACGATGAG
CAAGAAGCTAGAGACGGGGA -> AAGAAGCTAGAGACGGGGAT
CACGATATTGCGAAGCCCAG -> ACGATATTGCGAAGCCCAGT
TGTAGAGTAAGCAAGGATAA -> GTAGAGTAAGCAAGGATAAC
GAATCAGACTTACGGCGCTA -> AATCAGACTTACGGCGCTAA
CAGAGAGGAAGGTGTACAAA -> AGAGAGGAAGGTGTACAAAA
TGAACAATTTCCTGACGCTG -> GAACAATTTCCTGACGCTGG
GTGAGCCGCTAATGCCCCTT -> TGAGCCGCTAATGCCCCTTG
GCCTTTACTTCGTAAACAAA -> CCTTTACTTCGTAAACAAAA
TGCGAGGTGCACGCTAGTGT -> GCGAGGTGCACGCTAGTGTA
CCCCACGATATTGCGAAGCC -> CCCACGATATTGCGAAGCCC
GATGAATACACGCTCTGTGT -> ATGAATACACGCTCTGTGTA
ATGAGCTGTATCTCGAGGGG -> TGAGCTGTATCTCGAGGGGT
GACTTACGGCGCTAAACACC -> ACTTACGGCGCTAAACACCG
CTCGATGAATACACGCTCTG -> TCGATGAATACACGCTCTGT
CAGACTCTCCAGAGAGGAAG -> AGACTCTCCAGAGAGGAAGG
ACCGTTCCTCGCAAATCGTG -> CCGTTCCTCGCAAATCGTGG
CACAGATTGGCAGTCCTGTG -> ACAGATTGGCAGTCCTGTGA
GCTGTTACCGCTTATAGTGT -> CTGTTACCGCTTATAGTGTT
CTTCGTAAACAAAAATGTCG -> TTCGTAAACAAAAATGTCGT
CTACTTAGCCAGTTGCTCCA -> TACTTAGCCAGTTGCTCCAC
TGTTACCGCTTATAGTGTTA -> GTTACCGCTTATAGTGTTAC
TATCTCGAGGGGTTTGCGAG -> ATCTCGAGGGGTTTGCGAGG
ATTCAATGGTACGGCTAAAC -> TTCAATGGTACGGCTAAACT
TGTTACAAGTCGAACGCTCC -> GTTACAAGTCGAACGCTCCG
AAGTAGTTTCAGGCGATGAC -> AGTAGTTTCAGGCGATGACA