AAAAAGAAATG -> AAAAGAAATGG
AAAAAGGCTGT -> AAAAGGCTGTC
AAAAATACTCA -> AAAATACTCAA
AAAAGAAATGG -> AAAGAAATGGT
AAAAGCGGGGG -> AAAGCGGGGGG
AAAAGGCTGTC -> AAAGGCTGTCC
AAAAGTGATAG -> AAAGTGATAGA
AAAATACTCAA -> AAATACTCAAC
AAACACGGAAG -> AACACGGAAGC
AAACCCGTGAG -> AACCCGTGAGG
AAACGATGTAA -> AACGATGTAAT
AAACGCACGCT -> AACGCACGCTG
AAAGAAATGGT -> AAGAAATGGTG
AAAGATTCCCT -> AAGATTCCCTT
AAAGATTGTGA -> AAGATTGTGAT
AAAGCCCGAGA -> AAGCCCGAGAA
AAAGCCTTTGG -> AAGCCTTTGGG
AAAGCGGGGGG -> AAGCGGGGGGT
AAAGGATCCAA -> AAGGATCCAAG
AAAGGCTGTCC -> AAGGCTGTCCT
AAAGGGCAATC -> AAGGGCAATCA
AAAGTAACCCG -> AAGTAACCCGG
AAAGTACTGTC -> AAGTACTGTCA
AAAGTGATAGA -> AAGTGATAGAT
AAATACTCAAC -> AATACTCAACA
AAATATTGTAA -> AATATTGTAAC
AAATCTAAGGC -> AATCTAAGGCA
AAATCTGTGGG -> AATCTGTGGGC
AAATGGTGATA -> AATGGTGATAA
AAATGTGACAT -> AATGTGACATC
AAATTAGTTCT -> AATTAGTTCTC
AAATTTAAGGG -> AATTTAAGGGA
AACAAGAGCCC -> ACAAGAGCCCT
AACAATTGATT -> ACAATTGATTT
AACACATTTAA -> ACACATTTAAC
AACACGGAAGC -> ACACGGAAGCT
AACACGTTAAG -> ACACGTTAAGG
AACACTGTCAT -> ACACTGTCATT
AACAGCCAGGC -> ACAGCCAGGCA
AACCCGGTCAT -> ACCCGGTCATT
AACCCGTGAGG -> ACCCGTGAGGA
AACCCGTGCCT -> ACCCGTGCCTG
AACCTTACTTT -> ACCTTACTTTG
AACGATGTAAT -> ACGATGTAATC
AACGATGTTTC -> ACGATGTTTCG
AACGCACGCTG -> ACGCACGCTGT
AACGGGATGTT -> ACGGGATGTTA
AACGGTATGGA -> ACGGTATGGAA
AACGTATGACC -> ACGTATGACCC
AACTAAAGATT -> ACTAAAGATTC
AACTCCGAGGT -> ACTCCGAGGTC
AACTCCTACGA -> ACTCCTACGAT
AACTCCTAGGC -> ACTCCTAGGCT
AACTCGGTAAA -> ACTCGGTAAAA
AACTGCCTCGA -> ACTGCCTCGAG
AACTGCGTAAA -> ACTGCGTAAAA
AAGAAAGTACT -> AGAAAGTACTG
AAGAAATGGTG -> AGAAATGGTGA
AAGAGCCCTTA -> AGAGCCCTTAG
AAGATTCCCTT -> AGATTCCCTTC
AAGATTGTGAT -> AGATTGTGATA
AAGCAACGTAT -> AGCAACGTATG
AAGCAGGTTGT -> AGCAGGTTGTA
AAGCCATTAGC -> AGCCATTAGCT
AAGCCCGAGAA -> AGCCCGAGAAT
AAGCCGCAACA -> AGCCGCAACAA
AAGCCGCTGTA -> AGCCGCTGTAG
AAGCCGTGGAA -> AGCCGTGGAAA
AAGCCTTTGGG -> AGCCTTTGGGC
AAGCGGGGGGT -> AGCGGGGGGTT
AAGCGTTGATT -> AGCGTTGATTA
AAGCTAAGGTT -> AGCTAAGGTTT
AAGCTGATTGC -> AGCTGATTGCG
AAGGATCCAAG -> AGGATCCAAGT
AAGGCATTGTA -> AGGCATTGTAG
AAGGCTGTCCT -> AGGCTGTCCTC
AAGGGACTGCT -> AGGGACTGCTC
AAGGGATGATA -> AGGGATGATAC
AAGGGCAATCA -> AGGGCAATCAG
AAGGGGTGCTA -> AGGGGTGCTAG
AAGGTATCCTC -> AGGTATCCTCC
AAGGTTTCGGC -> AGGTTTCGGCT
AAGTAACCCGG -> AGTAACCCGGT
AAGTACTGTCA -> AGTACTGTCAA
AAGTCCGGACT -> AGTCCGGACTA
AAGTCGTAGCC -> AGTCGTAGCCG
AAGTGATAGAT -> AGTGATAGATA
AAGTGATATGG -> AGTGATATGGC
AAGTGATCGCA -> AGTGATCGCAC
AAGTTCGCGTC -> AGTTCGCGTCG
AATAAGAAAGT -> ATAAGAAAGTA
AATACTCAACA -> ATACTCAACAA
AATAGGGCCTA -> ATAGGGCCTAC
AATAGTACCAT -> ATAGTACCATC
AATAGTCTCGT -> ATAGTCTCGTA
AATATAAGCCA -> ATATAAGCCAT
AATATTGTAAC -> ATATTGTAACG
AATCAGACGAT -> ATCAGACGATA
AATCAGCCGAC -> ATCAGCCGACC
AATCATGCTGT -> ATCATGCTGTC
AATCCCTTAAT -> ATCCCTTAATT
AATCCTCACCC -> ATCCTCACCCG
AATCGAATGGA -> ATCGAATGGAA
AATCTAAGGCA -> ATCTAAGGCAT
AATCTGTGGGC -> ATCTGTGGGCC
AATGACTCTCT -> ATGACTCTCTA
AATGCACTCAT -> ATGCACTCATT
AATGCGATGAG -> ATGCGATGAGA
AATGGAAAGGG -> ATGGAAAGGGC
AATGGCAGGTG -> ATGGCAGGTGT
AATGGCTATGT -> ATGGCTATGTC
AATGGTGATAA -> ATGGTGATAAA
AATGTGACATC -> ATGTGACATCG
AATTACTAGGG -> ATTACTAGGGA
AATTAGTTCTC -> ATTAGTTCTCT
AATTCATCCGT -> ATTCATCCGTT
AATTGATTCCC -> ATTGATTCCCC
AATTGATTTCC -> ATTGATTTCCT
AATTGGTGACT -> ATTGGTGACTG
AATTGGTGTAC -> ATTGGTGTACA
AATTTAAATCT -> ATTTAAATCTA
AATTTAAGGGA -> ATTTAAGGGAC
AATTTACAGAT -> ATTTACAGATC
ACAACCCGTGC -> CAACCCGTGCC
ACAACCTTACT -> CAACCTTACTT
ACAACTCCTAG -> CAACTCCTAGG
ACAAGAGCCCT -> CAAGAGCCCTT
ACAATCCTCAC -> CAATCCTCACC
ACAATGGCTAT -> CAATGGCTATG
ACAATTGATTT -> CAATTGATTTC
ACACAACTCCT -> CACAACTCCTA
ACACATTTAAC -> CACATTTAACG
ACACCAATGGC -> CACCAATGGCA
ACACCGGCTCG -> CACCGGCTCGA
ACACGCGCGTC -> CACGCGCGTCA
ACACGGAAGCT -> CACGGAAGCTG
ACACGTTAAGG -> CACGTTAAGGG
ACACTATACCA -> CACTATACCAT
ACACTGGTACC -> CACTGGTACCG
ACACTGTCATT -> CACTGTCATTT
ACAGATCCGAT -> CAGATCCGATG
ACAGCCAGGCA -> CAGCCAGGCAC
ACAGGTCCCCG -> CAGGTCCCCGC
ACAGTCCCGCA -> CAGTCCCGCAC
ACATCAGTCCT -> CATCAGTCCTT
ACATCGCAGGT -> CATCGCAGGTT
ACATGGGGCAG -> CATGGGGCAGT
ACATTACCGAC -> CATTACCGACA
ACATTGGGGCC -> CATTGGGGCCT
ACATTGTCGGG -> CATTGTCGGGG
ACATTTAACGG -> CATTTAACGGG
ACCAAGCAACG -> CCAAGCAACGT
ACCAATGGCAG -> CCAATGGCAGG
ACCAGAATGAC -> CCAGAATGACT
ACCATAACTCC -> CCATAACTCCT
ACCATATGGCA -> CCATATGGCAA
ACCATCACGGC -> CCATCACGGCT
ACCATCGGAAC -> CCATCGGAACT
ACCCAGTAAGG -> CCCAGTAAGGG
ACCCATAAAAG -> CCCATAAAAGT
ACCCATGCATA -> CCCATGCATAA
ACCCGACAGTC -> CCCGACAGTCC
ACCCGGTACTC -> CCCGGTACTCC
ACCCGGTCATT -> CCCGGTCATTT
ACCCGTGAGGA -> CCCGTGAGGAG
ACCCGTGCCTG -> CCCGTGCCTGA
ACCGACATTGT -> CCGACATTGTC
ACCGACGAGGA -> CCGACGAGGAA
ACCGACGCGCG -> CCGACGCGCGC
ACCGCGCGGAA -> CCGCGCGGAAC
ACCGCTTCGAT -> CCGCTTCGATC
ACCGGCACGCA -> CCGGCACGCAG
ACCGGCTCGAT -> CCGGCTCGATG
ACCGGGTTTCT -> CCGGGTTTCTG
ACCGTATATTG -> CCGTATATTGG
ACCGTTAGATA -> CCGTTAGATAT
ACCTAGCCGCG -> CCTAGCCGCGG
ACCTATAAATG -> CCTATAAATGT
ACCTCCCACAC -> CCTCCCACACT
ACCTGGCCCCT -> CCTGGCCCCTC
ACCTTACTTTG -> CCTTACTTTGA
ACGAACACGTT -> CGAACACGTTA
ACGACATCAGT -> CGACATCAGTC
ACGAGACGGAG -> CGAGACGGAGG
ACGAGGAATTG -> CGAGGAATTGA
ACGATACTAAC -> CGATACTAACT
ACGATGAAAGA -> CGATGAAAGAT
ACGATGCTGAG -> CGATGCTGAGG
ACGATGTAATC -> CGATGTAATCC
ACGATGTTCTG -> CGATGTTCTGG
ACGATGTTTCG -> CGATGTTTCGA
ACGCAAAAATA -> CGCAAAAATAC
ACGCACGCTGT -> CGCACGCTGTG
ACGCAGGAATG -> CGCAGGAATGC
ACGCAGTTTTC -> CGCAGTTTTCC
ACGCGCGCGAG -> CGCGCGCGAGT
ACGCGCGTCAC -> CGCGCGTCACC
ACGCGCTGTCC -> CGCGCTGTCCG
ACGCTACAATC -> CGCTACAATCC
ACGCTGTGAGA -> CGCTGTGAGAC
ACGGAAGCTGA -> CGGAAGCTGAT
ACGGAGGTCTT -> CGGAGGTCTTA
ACGGCAGCTTG -> CGGCAGCTTGA
ACGGCCATAGC -> CGGCCATAGCT
ACGGCTGACCT -> CGGCTGACCTC
ACGGGATGTTA -> CGGGATGTTAT
ACGGTATGGAA -> CGGTATGGAAT
ACGGTGTGACA -> CGGTGTGACAG
ACGTATCGCAA -> CGTATCGCAAA
ACGTATGACCC -> CGTATGACCCA
ACGTCGCCGCG -> CGTCGCCGCGA
ACGTCTCCGGA -> CGTCTCCGGAT
ACGTTAAGGGG -> CGTTAAGGGGT
ACGTTCACGTA -> CGTTCACGTAT
ACGTTTGTCGA -> CGTTTGTCGAA
ACTAAAAAGAA -> CTAAAAAGAAA
ACTAAAGATTC -> CTAAAGATTCC
ACTAACTCCGA -> CTAACTCCGAG
ACTAACTGCCT -> CTAACTGCCTC
ACTACCTGGCC -> CTACCTGGCCC
ACTACTCGGGA -> CTACTCGGGAG
ACTACTTCGTC -> CTACTTCGTCT
ACTAGAGCCGT -> CTAGAGCCGTG
ACTAGCCACTT -> CTAGCCACTTA
ACTAGGGAGTA -> CTAGGGAGTAC
ACTAGGTCACA -> CTAGGTCACAT
ACTATACCATA -> CTATACCATAT
ACTCAACAAGA -> CTCAACAAGAG
ACTCAATAGGG -> CTCAATAGGGC
ACTCACTACTC -> CTCACTACTCG
ACTCACTACTT -> CTCACTACTTC
ACTCACTGTAG -> CTCACTGTAGG
ACTCATTCACC -> CTCATTCACCA
ACTCCAGCTCT -> CTCCAGCTCTG
ACTCCGAGGTC -> CTCCGAGGTCG
ACTCCGTCACC -> CTCCGTCACCG
ACTCCTACGAT -> CTCCTACGATG
ACTCCTAGGCT -> CTCCTAGGCTC
ACTCGGGAGCC -> CTCGGGAGCCA
ACTCGGTAAAA -> CTCGGTAAAAA
ACTCTACCGGC -> CTCTACCGGCA
ACTCTCTAAGC -> CTCTCTAAGCA
ACTCTTTCCGA -> CTCTTTCCGAC
ACTGAGTGTTG -> CTGAGTGTTGC
ACTGAGTTTTT -> CTGAGTTTTTG
ACTGATTACGC -> CTGATTACGCA
ACTGCCTCGAG -> CTGCCTCGAGC
ACTGCGTAAAA -> CTGCGTAAAAG
ACTGCTCGTGC -> CTGCTCGTGCG
ACTGGTACCGA -> CTGGTACCGAC
ACTGTAGGTTA -> CTGTAGGTTAG
ACTGTCAAGCC -> CTGTCAAGCCG
ACTGTCATTTG -> CTGTCATTTGA
ACTTATTAAGT -> CTTATTAAGTT
ACTTCCAAGTC -> CTTCCAAGTCC
ACTTCGTCTGT -> CTTCGTCTGTC
ACTTGATTGGT -> CTTGATTGGTG
ACTTTAAGCGT -> CTTTAAGCGTT
ACTTTGAATAG -> CTTTGAATAGT
AGAAAGGATCC -> GAAAGGATCCA
AGAAAGTACTG -> GAAAGTACTGT
AGAAATGGTGA -> GAAATGGTGAT
AGAACAGCCAG -> GAACAGCCAGG
AGAAGCCGCAA -> GAAGCCGCAAC
AGAATGACTCT -> GAATGACTCTC
AGAATTGGTGT -> GAATTGGTGTA
AGACATGGGGC -> GACATGGGGCA
AGACCATCACG -> GACCATCACGG
AGACGAGACGG -> GACGAGACGGA
AGACGATACTA -> GACGATACTAA
AGACGGAGGTC -> GACGGAGGTCT
AGACTAGCCAC -> GACTAGCCACT
AGAGACTAGCC -> GAGACTAGCCA
AGAGCAATATA -> GAGCAATATAA
AGAGCCCTTAG -> GAGCCCTTAGG
AGAGCCGTGGA -> GAGCCGTGGAA
AGAGGAGGTAA -> GAGGAGGTAAG
AGATAGCTCCG -> GATAGCTCCGG
AGATAGGAAAT -> GATAGGAAATT
AGATATTTTCC -> GATATTTTCCC
AGATCCGATGA -> GATCCGATGAT
AGATGTCCCAA -> GATGTCCCAAC
AGATTCCCTTC -> GATTCCCTTCC
AGATTGCGTCT -> GATTGCGTCTT
AGATTGTGATA -> GATTGTGATAC
AGCAACGTATG -> GCAACGTATGA
AGCAATATAAG -> GCAATATAAGC
AGCAGGTTGTA -> GCAGGTTGTAA
AGCATTTCCTT -> GCATTTCCTTG
AGCCACGGTGT -> GCCACGGTGTG
AGCCACTTATT -> GCCACTTATTA
AGCCAGAAAGG -> GCCAGAAAGGA
AGCCAGACCAT -> GCCAGACCATC
AGCCAGGCACG -> GCCAGGCACGG
AGCCATTAGCT -> GCCATTAGCTA
AGCCCGAGAAT -> GCCCGAGAATT
AGCCCTTAGGT -> GCCCTTAGGTG
AGCCGACCGTA -> GCCGACCGTAT
AGCCGCAACAA -> GCCGCAACAAT
AGCCGCGGTTC -> GCCGCGGTTCA
AGCCGCGTCGG -> GCCGCGTCGGC
AGCCGCTGTAG -> GCCGCTGTAGG
AGCCGGGCTCA -> GCCGGGCTCAT
AGCCGTGGAAA -> GCCGTGGAAAT
AGCCGTGGAAG -> GCCGTGGAAGC
AGCCTTTGGGC -> GCCTTTGGGCT
AGCGCACAATG -> GCGCACAATGG
AGCGCACGCTA -> GCGCACGCTAC
AGCGGGGGGTT -> GCGGGGGGTTG
AGCGTTGATTA -> GCGTTGATTAT
AGCTAAGGTTT -> GCTAAGGTTTC
AGCTACGGCCA -> GCTACGGCCAT
AGCTCCGGACT -> GCTCCGGACTC
AGCTCTGACGA -> GCTCTGACGAA
AGCTGATTGCG -> GCTGATTGCGC
AGCTGCGAGCC -> GCTGCGAGCCG
AGCTTCCCAAC -> GCTTCCCAACA
AGCTTGAAAGC -> GCTTGAAAGCC
AGCTTGAGATG -> GCTTGAGATGT
AGCTTGCCGGT -> GCTTGCCGGTC
AGGAAATTAGT -> GGAAATTAGTT
AGGAATGCACT -> GGAATGCACTC
AGGAATTGATT -> GGAATTGATTC
AGGACAACCCG -> GGACAACCCGT
AGGAGCGCACA -> GGAGCGCACAA
AGGAGGTAAGT -> GGAGGTAAGTG
AGGATCCAAGT -> GGATCCAAGTG
AGGCACGGCAG -> GGCACGGCAGC
AGGCATTGTAG -> GGCATTGTAGG
AGGCGAGTACC -> GGCGAGTACCT
AGGCTATAGTT -> GGCTATAGTTA
AGGCTCCTTAT -> GGCTCCTTATA
AGGCTGTCCTC -> GGCTGTCCTCG
AGGGACTGCTC -> GGGACTGCTCG
AGGGAGTACTA -> GGGAGTACTAG
AGGGATGATAC -> GGGATGATACT
AGGGCAATCAG -> GGGCAATCAGA
AGGGCCTACTC -> GGGCCTACTCC
AGGGGTGCTAG -> GGGGTGCTAGC
AGGGGTTAAAC -> GGGGTTAAACC
AGGTAAGTGAT -> GGTAAGTGATC
AGGTACTACCT -> GGTACTACCTG
AGGTATCCTCC -> GGTATCCTCCT
AGGTATGTAGA -> GGTATGTAGAC
AGGTCACATTG -> GGTCACATTGG
AGGTCCCCGCT -> GGTCCCCGCTC
AGGTCGTATAC -> GGTCGTATACT
AGGTCTTACTG -> GGTCTTACTGA
AGGTGACTCAA -> GGTGACTCAAT
AGGTGTAGATT -> GGTGTAGATTG
AGGTTAGAGGA -> GGTTAGAGGAG
AGGTTAGCCAG -> GGTTAGCCAGA
AGGTTGGGACA -> GGTTGGGACAC
AGGTTGTAATC -> GGTTGTAATCA
AGGTTTCGGCT -> GGTTTCGGCTA
AGTAACCCGGT -> GTAACCCGGTC
AGTAAGGGATG -> GTAAGGGATGA
AGTAATCGAAT -> GTAATCGAATG
AGTACCATCGG -> GTACCATCGGA
AGTACCTATAA -> GTACCTATAAA
AGTACTAGAGC -> GTACTAGAGCC
AGTACTGTCAA -> GTACTGTCAAG
AGTATAGTCAA -> GTATAGTCAAA
AGTCAAACACG -> GTCAAACACGG
AGTCACGACAT -> GTCACGACATC
AGTCCCGCACC -> GTCCCGCACCG
AGTCCGGACTA -> GTCCGGACTAG
AGTCCTTTAGG -> GTCCTTTAGGT
AGTCGCAGAAG -> GTCGCAGAAGC
AGTCGTAGCCG -> GTCGTAGCCGG
AGTCTCGTACT -> GTCTCGTACTT
AGTGATAGATA -> GTGATAGATAG
AGTGATATGGC -> GTGATATGGCA
AGTGATCGCAC -> GTGATCGCACA
AGTGTTGCCAA -> GTGTTGCCAAT
AGTTATCCCTC -> GTTATCCCTCG
AGTTCGCGTCG -> GTTCGCGTCGG
AGTTCTCTAAT -> GTTCTCTAATA
AGTTTTCCCTC -> GTTTTCCCTCG
AGTTTTTGGAC -> GTTTTTGGACG
ATAAAAGTGAT -> TAAAAGTGATA
ATAAACGCACG -> TAAACGCACGC
ATAAATGTGAC -> TAAATGTGACA
ATAACTCCTAC -> TAACTCCTACG
ATAAGAAAGTA -> TAAGAAAGTAC
ATAAGCCATTA -> TAAGCCATTAG
ATAAGTCGTAG -> TAAGTCGTAGC
ATACCATATGG -> TACCATATGGC
ATACCTAGCCG -> TACCTAGCCGC
ATACGCAAAAA -> TACGCAAAAAT
ATACGTTTGTC -> TACGTTTGTCG
ATACTAACTCC -> TACTAACTCCG
ATACTCAACAA -> TACTCAACAAG
ATACTCACTGT -> TACTCACTGTA
ATACTCTTTCC -> TACTCTTTCCG
ATACTTCCAAG -> TACTTCCAAGT
ATACTTGATTG -> TACTTGATTGG
ATAGATAGCTC -> TAGATAGCTCC
ATAGCGCACGC -> TAGCGCACGCT
ATAGCTCCGGA -> TAGCTCCGGAC
ATAGCTTGAGA -> TAGCTTGAGAT
ATAGGAAATTA -> TAGGAAATTAG
ATAGGGCCTAC -> TAGGGCCTACT
ATAGTACCATC -> TAGTACCATCG
ATAGTATAGTC -> TAGTATAGTCA
ATAGTCAAACA -> TAGTCAAACAC
ATAGTCTCGTA -> TAGTCTCGTAC
ATAGTTATCCC -> TAGTTATCCCT
ATATAAGCCAT -> TATAAGCCATT
ATATGGCAAAT -> TATGGCAAATA
ATATGGCAAGG -> TATGGCAAGGT
ATATTGGGACT -> TATTGGGACTC
ATATTGTAACG -> TATTGTAACGG
ATATTTTCCCC -> TATTTTCCCCG
ATCACGGCTGA -> TCACGGCTGAC
ATCAGACGATA -> TCAGACGATAC
ATCAGCCGACC -> TCAGCCGACCG
ATCAGTCCTTT -> TCAGTCCTTTA
ATCATGCTGTC -> TCATGCTGTCA
ATCCAAGTGAT -> TCCAAGTGATA
ATCCCGACTCA -> TCCCGACTCAC
ATCCCTCGCAC -> TCCCTCGCACA
ATCCCTTAATT -> TCCCTTAATTG
ATCCGATGATA -> TCCGATGATAC
ATCCGTTGTAC -> TCCGTTGTACG
ATCCTCACCCG -> TCCTCACCCGA
ATCCTCCTGCG -> TCCTCCTGCGT
ATCGAATGGAA -> TCGAATGGAAA
ATCGACGTCTC -> TCGACGTCTCC
ATCGCAAATCT -> TCGCAAATCTG
ATCGCACATTA -> TCGCACATTAC
ATCGCAGGTTA -> TCGCAGGTTAG
ATCGGAACTCG -> TCGGAACTCGG
ATCTAAGGCAT -> TCTAAGGCATT
ATCTGTGGGCC -> TCTGTGGGCCC
ATGAAAGATTG -> TGAAAGATTGT
ATGAATTCATC -> TGAATTCATCC
ATGACCCATAA -> TGACCCATAAA
ATGACTCTCTA -> TGACTCTCTAA
ATGAGAACAGC -> TGAGAACAGCC
ATGATACGCAA -> TGATACGCAAA
ATGATACTCTT -> TGATACTCTTT
ATGCACTCATT -> TGCACTCATTC
ATGCATAAGTC -> TGCATAAGTCG
ATGCGATGAGA -> TGCGATGAGAA
ATGCTGAGGCT -> TGCTGAGGCTA
ATGCTGTCATG -> TGCTGTCATGT
ATGGAAAGGGC -> TGGAAAGGGCA
ATGGAATTTAC -> TGGAATTTACA
ATGGCAAATAT -> TGGCAAATATT
ATGGCAAGGTA -> TGGCAAGGTAT
ATGGCAGGTGT -> TGGCAGGTGTA
ATGGCTATGTC -> TGGCTATGTCG
ATGGGGCAGTC -> TGGGGCAGTCA
ATGGTGATAAA -> TGGTGATAAAC
ATGTAATCCCT -> TGTAATCCCTT
ATGTAGACATG -> TGTAGACATGG
ATGTCCCAACT -> TGTCCCAACTG
ATGTCGGAAAG -> TGTCGGAAAGC
ATGTCGTTCAC -> TGTCGTTCACT
ATGTGACATCG -> TGTGACATCGC
ATGTTATTAAA -> TGTTATTAAAC
ATGTTCTGGTT -> TGTTCTGGTTT
ATGTTTCGAGT -> TGTTTCGAGTA
ATTAAACGATG -> TTAAACGATGT
ATTAAGTTCGC -> TTAAGTTCGCG
ATTACCGACAT -> TTACCGACATT
ATTACGCAGTT -> TTACGCAGTTT
ATTACTAGGGA -> TTACTAGGGAG
ATTAGCTACGG -> TTAGCTACGGC
ATTAGTTCTCT -> TTAGTTCTCTA
ATTATAGCGCA -> TTATAGCGCAC
ATTCACCAGAA -> TTCACCAGAAT
ATTCATCCGTT -> TTCATCCGTTG
ATTCCCCGACA -> TTCCCCGACAC
ATTCCCTTCCT -> TTCCCTTCCTC
ATTGATTCCCC -> TTGATTCCCCG
ATTGATTTCCT -> TTGATTTCCTT
ATTGCCAACTA -> TTGCCAACTAA
ATTGCGCGCTG -> TTGCGCGCTGC
ATTGCGTCTTG -> TTGCGTCTTGA
ATTGGGACTCA -> TTGGGACTCAC
ATTGGGGCCTA -> TTGGGGCCTAC
ATTGGTGACTG -> TTGGTGACTGA
ATTGGTGATCC -> TTGGTGATCCC
ATTGGTGTACA -> TTGGTGTACAC
ATTGTAACGGT -> TTGTAACGGTA
ATTGTACCGAC -> TTGTACCGACG
ATTGTAGGCGA -> TTGTAGGCGAG
ATTGTCGGGGG -> TTGTCGGGGGA
ATTGTGAGCCA -> TTGTGAGCCAG
ATTGTGATACT -> TTGTGATACTT
ATTTAAATCTA -> TTTAAATCTAA
ATTTAACGGGA -> TTTAACGGGAT
ATTTAAGGGAC -> TTTAAGGGACT
ATTTACAGATC -> TTTACAGATCC
ATTTCATTGTA -> TTTCATTGTAC
ATTTCCTTGAT -> TTTCCTTGATA
ATTTCCTTTTT -> TTTCCTTTTTG
ATTTCTGTACA -> TTTCTGTACAC
ATTTGAGATAG -> TTTGAGATAGG
ATTTTCCCCGT -> TTTTCCCCGTC
CAAAAATACTC -> AAAAATACTCA
CAAACACGGAA -> AAACACGGAAG
CAAATATTGTA -> AAATATTGTAA
CAAATCTGTGG -> AAATCTGTGGG
CAACAAGAGCC -> AACAAGAGCCC
CAACAATTGAT -> AACAATTGATT
CAACATTGCTA -> AACATTGCTAG
CAACCCGTGCC -> AACCCGTGCCT
CAACCTTACTT -> AACCTTACTTT
CAACGTATGAC -> AACGTATGACC
CAACTAAAGAT -> AACTAAAGATT
CAACTCCTAGG -> AACTCCTAGGC
CAACTGCGTAA -> AACTGCGTAAA
CAAGAGCCCTT -> AAGAGCCCTTA
CAAGCAACGTA -> AAGCAACGTAT
CAAGCCGCTGT -> AAGCCGCTGTA
CAAGGTATCCT -> AAGGTATCCTC
CAAGTCCGGAC -> AAGTCCGGACT
CAAGTGATATG -> AAGTGATATGG
CAATAGGGCCT -> AATAGGGCCTA
CAATATAAGCC -> AATATAAGCCA
CAATCAGACGA -> AATCAGACGAT
CAATCCTCACC -> AATCCTCACCC
CAATGGCAGGT -> AATGGCAGGTG
CAATGGCTATG -> AATGGCTATGT
CAATTACTAGG -> AATTACTAGGG
CAATTGATTTC -> AATTGATTTCC
CACAACCTTAC -> ACAACCTTACT
CACAACTCCTA -> ACAACTCCTAG
CACAATGGCTA -> ACAATGGCTAT
CACACTATACC -> ACACTATACCA
CACACTGGTAC -> ACACTGGTACC
CACATTACCGA -> ACATTACCGAC
CACATTGGGGC -> ACATTGGGGCC
CACATTTAACG -> ACATTTAACGG
CACCAATGGCA -> ACCAATGGCAG
CACCAGAATGA -> ACCAGAATGAC
CACCCGACAGT -> ACCCGACAGTC
CACCGCGCGGA -> ACCGCGCGGAA
CACCGCTTCGA -> ACCGCTTCGAT
CACCGGCTCGA -> ACCGGCTCGAT
CACCGTTAGAT -> ACCGTTAGATA
CACGACATCAG -> ACGACATCAGT
CACGCAGGAAT -> ACGCAGGAATG
CACGCGCGTCA -> ACGCGCGTCAC
CACGCTACAAT -> ACGCTACAATC
CACGCTGTGAG -> ACGCTGTGAGA
CACGGAAGCTG -> ACGGAAGCTGA
CACGGCAGCTT -> ACGGCAGCTTG
CACGGCTGACC -> ACGGCTGACCT
CACGGTGTGAC -> ACGGTGTGACA
CACGTATCGCA -> ACGTATCGCAA
CACGTTAAGGG -> ACGTTAAGGGG
CACTAAAAAGA -> ACTAAAAAGAA
CACTAACTGCC -> ACTAACTGCCT
CACTACTCGGG -> ACTACTCGGGA
CACTACTTCGT -> ACTACTTCGTC
CACTATACCAT -> ACTATACCATA
CACTCATTCAC -> ACTCATTCACC
CACTGATTACG -> ACTGATTACGC
CACTGGTACCG -> ACTGGTACCGA
CACTGTAGGTT -> ACTGTAGGTTA
CACTGTCATTT -> ACTGTCATTTG
CACTTATTAAG -> ACTTATTAAGT
CAGAAAGGATC -> AGAAAGGATCC
CAGAAGCCGCA -> AGAAGCCGCAA
CAGAATGACTC -> AGAATGACTCT
CAGACCATCAC -> AGACCATCACG
CAGACGATACT -> AGACGATACTA
CAGATCCGATG -> AGATCCGATGA
CAGCCAGGCAC -> AGCCAGGCACG
CAGCCGACCGT -> AGCCGACCGTA
CAGCTCTGACG -> AGCTCTGACGA
CAGCTTCCCAA -> AGCTTCCCAAC
CAGCTTGAAAG -> AGCTTGAAAGC
CAGGAATGCAC -> AGGAATGCACT
CAGGCACGGCA -> AGGCACGGCAG
CAGGGGTTAAA -> AGGGGTTAAAC
CAGGTCCCCGC -> AGGTCCCCGCT
CAGGTGTAGAT -> AGGTGTAGATT
CAGGTTAGAGG -> AGGTTAGAGGA
CAGGTTGTAAT -> AGGTTGTAATC
CAGTAAGGGAT -> AGTAAGGGATG
CAGTCACGACA -> AGTCACGACAT
CAGTCCCGCAC -> AGTCCCGCACC
CAGTCCTTTAG -> AGTCCTTTAGG
CAGTTTTCCCT -> AGTTTTCCCTC
CATAAAAGTGA -> ATAAAAGTGAT
CATAACTCCTA -> ATAACTCCTAC
CATAAGTCGTA -> ATAAGTCGTAG
CATACGTTTGT -> ATACGTTTGTC
CATAGCTTGAG -> ATAGCTTGAGA
CATATGGCAAA -> ATATGGCAAAT
CATCACGGCTG -> ATCACGGCTGA
CATCAGTCCTT -> ATCAGTCCTTT
CATCCGTTGTA -> ATCCGTTGTAC
CATCGCAGGTT -> ATCGCAGGTTA
CATCGGAACTC -> ATCGGAACTCG
CATGCATAAGT -> ATGCATAAGTC
CATGCTGTCAT -> ATGCTGTCATG
CATGGGGCAGT -> ATGGGGCAGTC
CATGTCGTTCA -> ATGTCGTTCAC
CATTACCGACA -> ATTACCGACAT
CATTAGCTACG -> ATTAGCTACGG
CATTCACCAGA -> ATTCACCAGAA
CATTGCCAACT -> ATTGCCAACTA
CATTGGGGCCT -> ATTGGGGCCTA
CATTGTACCGA -> ATTGTACCGAC
CATTGTAGGCG -> ATTGTAGGCGA
CATTGTCGGGG -> ATTGTCGGGGG
CATTGTGAGCC -> ATTGTGAGCCA
CATTTAACGGG -> ATTTAACGGGA
CATTTCATTGT -> ATTTCATTGTA
CATTTCCTTGA -> ATTTCCTTGAT
CATTTCTGTAC -> ATTTCTGTACA
CATTTGAGATA -> ATTTGAGATAG
CCAACATTGCT -> CAACATTGCTA
CCAACTAAAGA -> CAACTAAAGAT
CCAACTGCGTA -> CAACTGCGTAA
CCAAGCAACGT -> CAAGCAACGTA
CCAAGTCCGGA -> CAAGTCCGGAC
CCAAGTGATAT -> CAAGTGATATG
CCAATGGCAGG -> CAATGGCAGGT
CCAATTACTAG -> CAATTACTAGG
CCACAACCTTA -> CACAACCTTAC
CCACACTGGTA -> CACACTGGTAC
CCACGGTGTGA -> CACGGTGTGAC
CCACTAACTGC -> CACTAACTGCC
CCACTTATTAA -> CACTTATTAAG
CCAGAAAGGAT -> CAGAAAGGATC
CCAGAATGACT -> CAGAATGACTC
CCAGACCATCA -> CAGACCATCAC
CCAGCTCTGAC -> CAGCTCTGACG
CCAGCTTCCCA -> CAGCTTCCCAA
CCAGGCACGGC -> CAGGCACGGCA
CCAGTAAGGGA -> CAGTAAGGGAT
CCATAAAAGTG -> CATAAAAGTGA
CCATAACTCCT -> CATAACTCCTA
CCATACGTTTG -> CATACGTTTGT
CCATAGCTTGA -> CATAGCTTGAG
CCATATGGCAA -> CATATGGCAAA
CCATCACGGCT -> CATCACGGCTG
CCATCGGAACT -> CATCGGAACTC
CCATGCATAAG -> CATGCATAAGT
CCATTAGCTAC -> CATTAGCTACG
CCCAACATTGC -> CCAACATTGCT
CCCAACTGCGT -> CCAACTGCGTA
CCCACACTGGT -> CCACACTGGTA
CCCAGCTTCCC -> CCAGCTTCCCA
CCCAGTAAGGG -> CCAGTAAGGGA
CCCATAAAAGT -> CCATAAAAGTG
CCCATACGTTT -> CCATACGTTTG
CCCATGCATAA -> CCATGCATAAG
CCCCGACACCG -> CCCGACACCGG
CCCCGCTCTGT -> CCCGCTCTGTG
CCCCGTCTAAT -> CCCGTCTAATC
CCCCTCTAACG -> CCCTCTAACGA
CCCGACACCGG -> CCGACACCGGC
CCCGACAGTCC -> CCGACAGTCCC
CCCGACTCACT -> CCGACTCACTA
CCCGAGAATTG -> CCGAGAATTGG
CCCGCACCGCG -> CCGCACCGCGC
CCCGCTCTGTG -> CCGCTCTGTGC
CCCGGTACTCC -> CCGGTACTCCG
CCCGGTCATTT -> CCGGTCATTTC
CCCGTCTAATC -> CCGTCTAATCA
CCCGTGAGGAG -> CCGTGAGGAGC
CCCGTGCCTGA -> CCGTGCCTGAA
CCCTACCCATG -> CCTACCCATGC
CCCTCGCACAC -> CCTCGCACACT
CCCTCGGCCCA -> CCTCGGCCCAG
CCCTCTAACGA -> CCTCTAACGAT
CCCTTAATTGG -> CCTTAATTGGT
CCCTTAGGTGA -> CCTTAGGTGAC
CCCTTCCTCTG -> CCTTCCTCTGT
CCGAATGCGAT -> CGAATGCGATG
CCGACACCGGC -> CGACACCGGCT
CCGACAGTCCC -> CGACAGTCCCG
CCGACATTGTC -> CGACATTGTCG
CCGACCAAGCA -> CGACCAAGCAA
CCGACCGTATA -> CGACCGTATAT
CCGACGAGGAA -> CGACGAGGAAT
CCGACGCGCGC -> CGACGCGCGCG
CCGACTCACTA -> CGACTCACTAC
CCGAGAATTGG -> CGAGAATTGGT
CCGAGGTCGTA -> CGAGGTCGTAT
CCGATGATACG -> CGATGATACGC
CCGCAACAATT -> CGCAACAATTG
CCGCACCGCGC -> CGCACCGCGCG
CCGCGAGGTAT -> CGCGAGGTATG
CCGCGCGGAAC -> CGCGCGGAACA
CCGCGGTTCAT -> CGCGGTTCATT
CCGCGTCGGCT -> CGCGTCGGCTT
CCGCTCTGTGC -> CGCTCTGTGCA
CCGCTGTAGGT -> CGCTGTAGGTA
CCGCTTCGATC -> CGCTTCGATCG
CCGGACTAGGT -> CGGACTAGGTC
CCGGACTCTAC -> CGGACTCTACC
CCGGATACTTC -> CGGATACTTCC
CCGGCACGCAG -> CGGCACGCAGG
CCGGCTCGATG -> CGGCTCGATGA
CCGGGCTCATT -> CGGGCTCATTG
CCGGGTTTCTG -> CGGGTTTCTGA
CCGGTACTCCG -> CGGTACTCCGT
CCGGTCATTTC -> CGGTCATTTCT
CCGGTCCGTAC -> CGGTCCGTACG
CCGTACGCGCT -> CGTACGCGCTG
CCGTATATTGG -> CGTATATTGGG
CCGTCACCGTT -> CGTCACCGTTA
CCGTCTAATCA -> CGTCTAATCAT
CCGTGAGGAGC -> CGTGAGGAGCG
CCGTGCCTGAA -> CGTGCCTGAAT
CCGTGGAAATT -> CGTGGAAATTT
CCGTGGAAGCT -> CGTGGAAGCTA
CCGTTAGATAT -> CGTTAGATATT
CCGTTGTACGT -> CGTTGTACGTT
CCTACCCATGC -> CTACCCATGCA
CCTACGATGAA -> CTACGATGAAA
CCTACGATGTT -> CTACGATGTTC
CCTACTCCAGC -> CTACTCCAGCT
CCTAGCCGCGG -> CTAGCCGCGGT
CCTAGGCTCCT -> CTAGGCTCCTT
CCTATAAATGT -> CTATAAATGTG
CCTCACCCGAC -> CTCACCCGACA
CCTCCCACACT -> CTCCCACACTG
CCTCCTGCGTC -> CTCCTGCGTCA
CCTCGAGCTTG -> CTCGAGCTTGC
CCTCGCACACT -> CTCGCACACTA
CCTCGCTCATT -> CTCGCTCATTG
CCTCGGCCCAG -> CTCGGCCCAGC
CCTCTAACGAT -> CTCTAACGATG
CCTCTGTAGCT -> CTCTGTAGCTG
CCTGAATAAGA -> CTGAATAAGAA
CCTGCGTCACT -> CTGCGTCACTA
CCTGGCCCCTC -> CTGGCCCCTCT
CCTTAATTGGT -> CTTAATTGGTG
CCTTACTTTGA -> CTTACTTTGAA
CCTTAGGTGAC -> CTTAGGTGACT
CCTTATAGTAT -> CTTATAGTATA
CCTTCCTCTGT -> CTTCCTCTGTA
CCTTGATACCT -> CTTGATACCTA
CCTTTAGGTTG -> CTTTAGGTTGG
CCTTTGGGCTT -> CTTTGGGCTTA
CCTTTTTGTCC -> CTTTTTGTCCC
CGAACACATTT -> GAACACATTTA
CGAACACGTTA -> GAACACGTTAA
CGAAGCCGTGG -> GAAGCCGTGGA
CGAATGCGATG -> GAATGCGATGA
CGAATGGAAAG -> GAATGGAAAGG
CGACACCGGCT -> GACACCGGCTC
CGACAGTCCCG -> GACAGTCCCGC
CGACATCAGTC -> GACATCAGTCC
CGACATTGTCG -> GACATTGTCGG
CGACCAAGCAA -> GACCAAGCAAC
CGACCGTATAT -> GACCGTATATT
CGACGAGGAAT -> GACGAGGAATT
CGACGCGCGCG -> GACGCGCGCGA
CGACGTCTCCG -> GACGTCTCCGG
CGACTCACTAC -> GACTCACTACT
CGAGAATTGGT -> GAGAATTGGTG
CGAGACGGAGG -> GAGACGGAGGT
CGAGCCGCGTC -> GAGCCGCGTCG
CGAGCTTGCCG -> GAGCTTGCCGG
CGAGGAATTGA -> GAGGAATTGAT
CGAGGTATGTA -> GAGGTATGTAG
CGAGGTCGTAT -> GAGGTCGTATA
CGAGTAATCGA -> GAGTAATCGAA
CGAGTACCTAT -> GAGTACCTATA
CGAGTCGCAGA -> GAGTCGCAGAA
CGATACTAACT -> GATACTAACTC
CGATCGACGTC -> GATCGACGTCT
CGATGAAAGAT -> GATGAAAGATT
CGATGAATTCA -> GATGAATTCAT
CGATGAGAACA -> GATGAGAACAG
CGATGATACGC -> GATGATACGCA
CGATGCTGAGG -> GATGCTGAGGC
CGATGTAATCC -> GATGTAATCCC
CGATGTTCTGG -> GATGTTCTGGT
CGATGTTTCGA -> GATGTTTCGAG
CGCAAAAATAC -> GCAAAAATACT
CGCAAATCTGT -> GCAAATCTGTG
CGCAACAATTG -> GCAACAATTGA
CGCACAATGGC -> GCACAATGGCT
CGCACACTATA -> GCACACTATAC
CGCACATTACC -> GCACATTACCG
CGCACCGCGCG -> GCACCGCGCGG
CGCACGCTACA -> GCACGCTACAA
CGCACGCTGTG -> GCACGCTGTGA
CGCAGAAGCCG -> GCAGAAGCCGC
CGCAGGAATGC -> GCAGGAATGCA
CGCAGGTTAGA -> GCAGGTTAGAG
CGCAGTTTTCC -> GCAGTTTTCCC
CGCCACAACCT -> GCCACAACCTT
CGCCGCGAGGT -> GCCGCGAGGTA
CGCGAGGTATG -> GCGAGGTATGT
CGCGAGTCGCA -> GCGAGTCGCAG
CGCGCGAGTCG -> GCGCGAGTCGC
CGCGCGCGAGT -> GCGCGCGAGTC
CGCGCGGAACA -> GCGCGGAACAC
CGCGCGTCACC -> GCGCGTCACCG
CGCGCTGCTGC -> GCGCTGCTGCT
CGCGCTGTCCG -> GCGCTGTCCGA
CGCGGAACACT -> GCGGAACACTG
CGCGGTTCATT -> GCGGTTCATTT
CGCGTCACCGC -> GCGTCACCGCT
CGCGTCGGCTT -> GCGTCGGCTTG
CGCGTCGGGCG -> GCGTCGGGCGA
CGCTACAATCC -> GCTACAATCCT
CGCTCATTGTG -> GCTCATTGTGA
CGCTCTGTGCA -> GCTCTGTGCAG
CGCTGCTGCTA -> GCTGCTGCTAC
CGCTGTAGGTA -> GCTGTAGGTAC
CGCTGTCCGAA -> GCTGTCCGAAT
CGCTGTGAGAC -> GCTGTGAGACG
CGCTTCGATCG -> GCTTCGATCGA
CGGAAAGCCCG -> GGAAAGCCCGA
CGGAACACTGT -> GGAACACTGTC
CGGAACTCGGT -> GGAACTCGGTA
CGGAAGCTGAT -> GGAAGCTGATT
CGGACTAGGTC -> GGACTAGGTCA
CGGACTCTACC -> GGACTCTACCG
CGGAGGTCTTA -> GGAGGTCTTAC
CGGATACTTCC -> GGATACTTCCA
CGGCACGCAGG -> GGCACGCAGGA
CGGCAGCTTGA -> GGCAGCTTGAA
CGGCCATAGCT -> GGCCATAGCTT
CGGCCCAGCTT -> GGCCCAGCTTC
CGGCTACCCAG -> GGCTACCCAGT
CGGCTCGATGA -> GGCTCGATGAA
CGGCTGACCTC -> GGCTGACCTCC
CGGCTTGAAAG -> GGCTTGAAAGT
CGGGACCCGGT -> GGGACCCGGTA
CGGGAGCCACG -> GGGAGCCACGG
CGGGATGTTAT -> GGGATGTTATT
CGGGCGAACAC -> GGGCGAACACA
CGGGCTCATTG -> GGGCTCATTGC
CGGGGGACGTC -> GGGGGACGTCG
CGGGGGGTTGT -> GGGGGGTTGTA
CGGGTTTCTGA -> GGGTTTCTGAG
CGGTAAAAAGG -> GGTAAAAAGGC
CGGTACTCCGT -> GGTACTCCGTC
CGGTATGGAAT -> GGTATGGAATT
CGGTCATTTCT -> GGTCATTTCTG
CGGTCCGTACG -> GGTCCGTACGC
CGGTGTGACAG -> GGTGTGACAGG
CGGTTCATTTC -> GGTTCATTTCA
CGTAAAAGCGG -> GTAAAAGCGGG
CGTACGCGCTG -> GTACGCGCTGT
CGTACTTTAAG -> GTACTTTAAGC
CGTAGCCGGGC -> GTAGCCGGGCT
CGTATACTCAC -> GTATACTCACT
CGTATATTGGG -> GTATATTGGGA
CGTATCGCAAA -> GTATCGCAAAT
CGTATGACCCA -> GTATGACCCAT
CGTCACCGCTT -> GTCACCGCTTC
CGTCACCGTTA -> GTCACCGTTAG
CGTCACTAAAA -> GTCACTAAAAA
CGTCGCCGCGA -> GTCGCCGCGAG
CGTCGGCTTGA -> GTCGGCTTGAA
CGTCGGGCGAA -> GTCGGGCGAAC
CGTCTAATCAT -> GTCTAATCATG
CGTCTCCGGAT -> GTCTCCGGATA
CGTCTGTCCAC -> GTCTGTCCACT
CGTCTTGACCA -> GTCTTGACCAT
CGTGAGGAGCG -> GTGAGGAGCGC
CGTGCCTGAAT -> GTGCCTGAATA
CGTGCGGGACC -> GTGCGGGACCC
CGTGGAAATTT -> GTGGAAATTTA
CGTGGAAGCTA -> GTGGAAGCTAA
CGTTAAGGGGT -> GTTAAGGGGTG
CGTTAGATATT -> GTTAGATATTT
CGTTCACGTAT -> GTTCACGTATC
CGTTCACTGAT -> GTTCACTGATT
CGTTGATTATA -> GTTGATTATAG
CGTTGTACGTT -> GTTGTACGTTC
CGTTTGTCGAA -> GTTTGTCGAAG
CTAAAAAGAAA -> TAAAAAGAAAT
CTAAAGATTCC -> TAAAGATTCCC
CTAACGATGTT -> TAACGATGTTT
CTAACTCCGAG -> TAACTCCGAGG
CTAACTGCCTC -> TAACTGCCTCG
CTAAGCAGGTT -> TAAGCAGGTTG
CTAAGGCATTG -> TAAGGCATTGT
CTAAGGTTTCG -> TAAGGTTTCGG
CTAATAGTACC -> TAATAGTACCA
CTAATCATGCT -> TAATCATGCTG
CTACAATCCTC -> TACAATCCTCA
CTACCCAGTAA -> TACCCAGTAAG
CTACCCATGCA -> TACCCATGCAT
CTACCGGCACG -> TACCGGCACGC
CTACCGGGTTT -> TACCGGGTTTC
CTACCTGGCCC -> TACCTGGCCCC
CTACGATGAAA -> TACGATGAAAG
CTACGATGTTC -> TACGATGTTCT
CTACGGCCATA -> TACGGCCATAG
CTACTCCAGCT -> TACTCCAGCTC
CTACTCGGGAG -> TACTCGGGAGC
CTACTTCGTCT -> TACTTCGTCTG
CTAGAGCCGTG -> TAGAGCCGTGG
CTAGCATTTCC -> TAGCATTTCCT
CTAGCCACTTA -> TAGCCACTTAT
CTAGCCGCGGT -> TAGCCGCGGTT
CTAGGCTCCTT -> TAGGCTCCTTA
CTAGGGAGTAC -> TAGGGAGTACT
CTAGGTCACAT -> TAGGTCACATT
CTATAAATGTG -> TATAAATGTGA
CTATACCATAT -> TATACCATATG
CTATAGTTATC -> TATAGTTATCC
CTATGTCGGAA -> TATGTCGGAAA
CTCAACAAGAG -> TCAACAAGAGC
CTCAATAGGGC -> TCAATAGGGCC
CTCACCCGACA -> TCACCCGACAG
CTCACTACTCG -> TCACTACTCGG
CTCACTACTTC -> TCACTACTTCG
CTCACTGTAGG -> TCACTGTAGGT
CTCATTCACCA -> TCATTCACCAG
CTCATTGCCAA -> TCATTGCCAAC
CTCATTGTGAG -> TCATTGTGAGC
CTCCAGCTCTG -> TCCAGCTCTGA
CTCCCACACTG -> TCCCACACTGG
CTCCGAGGTCG -> TCCGAGGTCGT
CTCCGGACTCT -> TCCGGACTCTA
CTCCGGATACT -> TCCGGATACTT
CTCCGTCACCG -> TCCGTCACCGT
CTCCTACGATG -> TCCTACGATGT
CTCCTAGGCTC -> TCCTAGGCTCC
CTCCTGCGTCA -> TCCTGCGTCAC
CTCCTTATAGT -> TCCTTATAGTA
CTCGAGCTTGC -> TCGAGCTTGCC
CTCGATGAATT -> TCGATGAATTC
CTCGCACACTA -> TCGCACACTAT
CTCGCTCATTG -> TCGCTCATTGT
CTCGGCCCAGC -> TCGGCCCAGCT
CTCGGGAGCCA -> TCGGGAGCCAC
CTCGGTAAAAA -> TCGGTAAAAAG
CTCGTACTTTA -> TCGTACTTTAA
CTCGTGCGGGA -> TCGTGCGGGAC
CTCTAACGATG -> TCTAACGATGT
CTCTAAGCAGG -> TCTAAGCAGGT
CTCTAATAGTA -> TCTAATAGTAC
CTCTACCGGCA -> TCTACCGGCAC
CTCTCTAAGCA -> TCTCTAAGCAG
CTCTGACGAAC -> TCTGACGAACA
CTCTGTAGCTG -> TCTGTAGCTGC
CTCTGTGCAGG -> TCTGTGCAGGG
CTCTTTCCGAC -> TCTTTCCGACC
CTGAATAAGAA -> TGAATAAGAAA
CTGACCTCCCA -> TGACCTCCCAC
CTGACGAACAC -> TGACGAACACG
CTGAGAGACTA -> TGAGAGACTAG
CTGAGGCTATA -> TGAGGCTATAG
CTGAGTGTTGC -> TGAGTGTTGCC
CTGAGTTTTTG -> TGAGTTTTTGG
CTGATTACGCA -> TGATTACGCAG
CTGATTGCGCG -> TGATTGCGCGC
CTGCCTCGAGC -> TGCCTCGAGCT
CTGCGAGCCGC -> TGCGAGCCGCG
CTGCGTAAAAG -> TGCGTAAAAGC
CTGCGTCACTA -> TGCGTCACTAA
CTGCTACCGGG -> TGCTACCGGGT
CTGCTCGTGCG -> TGCTCGTGCGG
CTGCTGCTACC -> TGCTGCTACCG
CTGGCCCCTCT -> TGGCCCCTCTA
CTGGTACCGAC -> TGGTACCGACG
CTGGTTTTTCG -> TGGTTTTTCGC
CTGTACACAAC -> TGTACACAACT
CTGTAGCTGCG -> TGTAGCTGCGA
CTGTAGGTACT -> TGTAGGTACTA
CTGTAGGTTAG -> TGTAGGTTAGC
CTGTCAAGCCG -> TGTCAAGCCGC
CTGTCATGTCG -> TGTCATGTCGT
CTGTCATTTGA -> TGTCATTTGAG
CTGTCCACTAA -> TGTCCACTAAC
CTGTCCGAATG -> TGTCCGAATGC
CTGTCCTCGCT -> TGTCCTCGCTC
CTGTGAGACGA -> TGTGAGACGAG
CTGTGCAGGGG -> TGTGCAGGGGT
CTGTGGGCCCT -> TGTGGGCCCTA
CTTAATTGGTG -> TTAATTGGTGA
CTTACTGAGTT -> TTACTGAGTTT
CTTACTTTGAA -> TTACTTTGAAT
CTTAGAGCAAT -> TTAGAGCAATA
CTTAGGTGACT -> TTAGGTGACTC
CTTATAGTATA -> TTATAGTATAG
CTTATTAAGTT -> TTATTAAGTTC
CTTCCAAGTCC -> TTCCAAGTCCG
CTTCCCAACAT -> TTCCCAACATT
CTTCCTCTGTA -> TTCCTCTGTAG
CTTCGATCGAC -> TTCGATCGACG
CTTCGTCTGTC -> TTCGTCTGTCC
CTTGAAAGCCT -> TTGAAAGCCTT
CTTGAAAGTAA -> TTGAAAGTAAC
CTTGACCATAA -> TTGACCATAAC
CTTGAGATGTC -> TTGAGATGTCC
CTTGATACCTA -> TTGATACCTAG
CTTGATTGGTG -> TTGATTGGTGA
CTTGCCGGTCC -> TTGCCGGTCCG
CTTTAAGCGTT -> TTTAAGCGTTG
CTTTAGGTTGG -> TTTAGGTTGGG
CTTTCCGACCA -> TTTCCGACCAA
CTTTGAATAGT -> TTTGAATAGTC
CTTTGGGCTTA -> TTTGGGCTTAG
CTTTTTGTCCC -> TTTTTGTCCCA
GAAAGATTGTG -> AAAGATTGTGA
GAAAGCCCGAG -> AAAGCCCGAGA
GAAAGCCTTTG -> AAAGCCTTTGG
GAAAGGATCCA -> AAAGGATCCAA
GAAAGGGCAAT -> AAAGGGCAATC
GAAAGTAACCC -> AAAGTAACCCG
GAAAGTACTGT -> AAAGTACTGTC
GAAATGGTGAT -> AAATGGTGATA
GAAATTAGTTC -> AAATTAGTTCT
GAAATTTAAGG -> AAATTTAAGGG
GAACACATTTA -> AACACATTTAA
GAACACGTTAA -> AACACGTTAAG
GAACACTGTCA -> AACACTGTCAT
GAACAGCCAGG -> AACAGCCAGGC
GAACTCGGTAA -> AACTCGGTAAA
GAAGCCGCAAC -> AAGCCGCAACA
GAAGCCGTGGA -> AAGCCGTGGAA
GAAGCTAAGGT -> AAGCTAAGGTT
GAAGCTGATTG -> AAGCTGATTGC
GAATAAGAAAG -> AATAAGAAAGT
GAATAGTCTCG -> AATAGTCTCGT
GAATGACTCTC -> AATGACTCTCT
GAATGCACTCA -> AATGCACTCAT
GAATGCGATGA -> AATGCGATGAG
GAATGGAAAGG -> AATGGAAAGGG
GAATTCATCCG -> AATTCATCCGT
GAATTGATTCC -> AATTGATTCCC
GAATTGGTGTA -> AATTGGTGTAC
GAATTTACAGA -> AATTTACAGAT
GACAACCCGTG -> ACAACCCGTGC
GACACCGGCTC -> ACACCGGCTCG
GACACGCGCGT -> ACACGCGCGTC
GACAGGTCCCC -> ACAGGTCCCCG
GACAGTCCCGC -> ACAGTCCCGCA
GACATCAGTCC -> ACATCAGTCCT
GACATCGCAGG -> ACATCGCAGGT
GACATGGGGCA -> ACATGGGGCAG
GACATTGTCGG -> ACATTGTCGGG
GACCAAGCAAC -> ACCAAGCAACG
GACCATAACTC -> ACCATAACTCC
GACCATCACGG -> ACCATCACGGC
GACCCATAAAA -> ACCCATAAAAG
GACCCGGTACT -> ACCCGGTACTC
GACCGTATATT -> ACCGTATATTG
GACCTCCCACA -> ACCTCCCACAC
GACGAACACGT -> ACGAACACGTT
GACGAGACGGA -> ACGAGACGGAG
GACGAGGAATT -> ACGAGGAATTG
GACGATACTAA -> ACGATACTAAC
GACGATGCTGA -> ACGATGCTGAG
GACGCGCGCGA -> ACGCGCGCGAG
GACGGAGGTCT -> ACGGAGGTCTT
GACGTCGCCGC -> ACGTCGCCGCG
GACGTCTCCGG -> ACGTCTCCGGA
GACTAGCCACT -> ACTAGCCACTT
GACTAGGTCAC -> ACTAGGTCACA
GACTCAATAGG -> ACTCAATAGGG
GACTCACTACT -> ACTCACTACTC,ACTCACTACTT
GACTCTACCGG -> ACTCTACCGGC
GACTCTCTAAG -> ACTCTCTAAGC
GACTGAGTGTT -> ACTGAGTGTTG
GACTGCTCGTG -> ACTGCTCGTGC
GAGAACAGCCA -> AGAACAGCCAG
GAGAATTGGTG -> AGAATTGGTGT
GAGACGAGACG -> AGACGAGACGG
GAGACGGAGGT -> AGACGGAGGTC
GAGACTAGCCA -> AGACTAGCCAC
GAGAGACTAGC -> AGAGACTAGCC
GAGATAGGAAA -> AGATAGGAAAT
GAGATGTCCCA -> AGATGTCCCAA
GAGCAATATAA -> AGCAATATAAG
GAGCCACGGTG -> AGCCACGGTGT
GAGCCAGACCA -> AGCCAGACCAT
GAGCCCTTAGG -> AGCCCTTAGGT
GAGCCGCGTCG -> AGCCGCGTCGG
GAGCCGTGGAA -> AGCCGTGGAAG
GAGCGCACAAT -> AGCGCACAATG
GAGCTTGCCGG -> AGCTTGCCGGT
GAGGAATTGAT -> AGGAATTGATT
GAGGAGCGCAC -> AGGAGCGCACA
GAGGAGGTAAG -> AGGAGGTAAGT
GAGGCTATAGT -> AGGCTATAGTT
GAGGTAAGTGA -> AGGTAAGTGAT
GAGGTATGTAG -> AGGTATGTAGA
GAGGTCGTATA -> AGGTCGTATAC
GAGGTCTTACT -> AGGTCTTACTG
GAGTAATCGAA -> AGTAATCGAAT
GAGTACCTATA -> AGTACCTATAA
GAGTACTAGAG -> AGTACTAGAGC
GAGTCGCAGAA -> AGTCGCAGAAG
GAGTGTTGCCA -> AGTGTTGCCAA
GAGTTTTTGGA -> AGTTTTTGGAC
GATAAACGCAC -> ATAAACGCACG
GATACCTAGCC -> ATACCTAGCCG
GATACGCAAAA -> ATACGCAAAAA
GATACTAACTC -> ATACTAACTCC
GATACTCTTTC -> ATACTCTTTCC
GATACTTCCAA -> ATACTTCCAAG
GATACTTGATT -> ATACTTGATTG
GATAGATAGCT -> ATAGATAGCTC
GATAGCTCCGG -> ATAGCTCCGGA
GATAGGAAATT -> ATAGGAAATTA
GATATGGCAAG -> ATATGGCAAGG
GATATTTTCCC -> ATATTTTCCCC
GATCCAAGTGA -> ATCCAAGTGAT
GATCCCGACTC -> ATCCCGACTCA
GATCCGATGAT -> ATCCGATGATA
GATCGACGTCT -> ATCGACGTCTC
GATCGCACATT -> ATCGCACATTA
GATGAAAGATT -> ATGAAAGATTG
GATGAATTCAT -> ATGAATTCATC
GATGAGAACAG -> ATGAGAACAGC
GATGATACGCA -> ATGATACGCAA
GATGATACTCT -> ATGATACTCTT
GATGCTGAGGC -> ATGCTGAGGCT
GATGTAATCCC -> ATGTAATCCCT
GATGTCCCAAC -> ATGTCCCAACT
GATGTTATTAA -> ATGTTATTAAA
GATGTTCTGGT -> ATGTTCTGGTT
GATGTTTCGAG -> ATGTTTCGAGT
GATTACGCAGT -> ATTACGCAGTT
GATTATAGCGC -> ATTATAGCGCA
GATTCCCCGAC -> ATTCCCCGACA
GATTCCCTTCC -> ATTCCCTTCCT
GATTGCGCGCT -> ATTGCGCGCTG
GATTGCGTCTT -> ATTGCGTCTTG
GATTGGTGATC -> ATTGGTGATCC
GATTGTGATAC -> ATTGTGATACT
GATTTCCTTTT -> ATTTCCTTTTT
GCAAAAATACT -> CAAAAATACTC
GCAAATATTGT -> CAAATATTGTA
GCAAATCTGTG -> CAAATCTGTGG
GCAACAATTGA -> CAACAATTGAT
GCAACGTATGA -> CAACGTATGAC
GCAAGGTATCC -> CAAGGTATCCT
GCAATATAAGC -> CAATATAAGCC
GCAATCAGACG -> CAATCAGACGA
GCACAATGGCT -> CACAATGGCTA
GCACACTATAC -> CACACTATACC
GCACATTACCG -> CACATTACCGA
GCACCGCGCGG -> CACCGCGCGGA
GCACGCAGGAA -> CACGCAGGAAT
GCACGCTACAA -> CACGCTACAAT
GCACGCTGTGA -> CACGCTGTGAG
GCACGGCAGCT -> CACGGCAGCTT
GCACTCATTCA -> CACTCATTCAC
GCAGAAGCCGC -> CAGAAGCCGCA
GCAGCTTGAAA -> CAGCTTGAAAG
GCAGGAATGCA -> CAGGAATGCAC
GCAGGGGTTAA -> CAGGGGTTAAA
GCAGGTGTAGA -> CAGGTGTAGAT
GCAGGTTAGAG -> CAGGTTAGAGG
GCAGGTTGTAA -> CAGGTTGTAAT
GCAGTCACGAC -> CAGTCACGACA
GCAGTTTTCCC -> CAGTTTTCCCT
GCATAAGTCGT -> CATAAGTCGTA
GCATTGTAGGC -> CATTGTAGGCG
GCATTTCCTTG -> CATTTCCTTGA
GCCAACTAAAG -> CCAACTAAAGA
GCCAATTACTA -> CCAATTACTAG
GCCACAACCTT -> CCACAACCTTA
GCCACGGTGTG -> CCACGGTGTGA
GCCACTTATTA -> CCACTTATTAA
GCCAGAAAGGA -> CCAGAAAGGAT
GCCAGACCATC -> CCAGACCATCA
GCCAGGCACGG -> CCAGGCACGGC
GCCATAGCTTG -> CCATAGCTTGA
GCCATTAGCTA -> CCATTAGCTAC
GCCCAGCTTCC -> CCCAGCTTCCC
GCCCCTCTAAC -> CCCCTCTAACG
GCCCGAGAATT -> CCCGAGAATTG
GCCCTACCCAT -> CCCTACCCATG
GCCCTTAGGTG -> CCCTTAGGTGA
GCCGACCGTAT -> CCGACCGTATA
GCCGCAACAAT -> CCGCAACAATT
GCCGCGAGGTA -> CCGCGAGGTAT
GCCGCGGTTCA -> CCGCGGTTCAT
GCCGCGTCGGC -> CCGCGTCGGCT
GCCGCTGTAGG -> CCGCTGTAGGT
GCCGGGCTCAT -> CCGGGCTCATT
GCCGGTCCGTA -> CCGGTCCGTAC
GCCGTGGAAAT -> CCGTGGAAATT
GCCGTGGAAGC -> CCGTGGAAGCT
GCCTACGATGA -> CCTACGATGAA
GCCTACTCCAG -> CCTACTCCAGC
GCCTCGAGCTT -> CCTCGAGCTTG
GCCTGAATAAG -> CCTGAATAAGA
GCCTTTGGGCT -> CCTTTGGGCTT
GCGAACACATT -> CGAACACATTT
GCGAGCCGCGT -> CGAGCCGCGTC
GCGAGGTATGT -> CGAGGTATGTA
GCGAGTACCTA -> CGAGTACCTAT
GCGAGTCGCAG -> CGAGTCGCAGA
GCGATGAGAAC -> CGATGAGAACA
GCGCACAATGG -> CGCACAATGGC
GCGCACGCTAC -> CGCACGCTACA
GCGCGAGTCGC -> CGCGAGTCGCA
GCGCGCGAGTC -> CGCGCGAGTCG
GCGCGCTGCTG -> CGCGCTGCTGC
GCGCGGAACAC -> CGCGGAACACT
GCGCGTCACCG -> CGCGTCACCGC
GCGCTGCTGCT -> CGCTGCTGCTA
GCGCTGTCCGA -> CGCTGTCCGAA
GCGGAACACTG -> CGGAACACTGT
GCGGGACCCGG -> CGGGACCCGGT
GCGGGGGGTTG -> CGGGGGGTTGT
GCGGTTCATTT -> CGGTTCATTTC
GCGTAAAAGCG -> CGTAAAAGCGG
GCGTCACCGCT -> CGTCACCGCTT
GCGTCACTAAA -> CGTCACTAAAA
GCGTCGGCTTG -> CGTCGGCTTGA
GCGTCGGGCGA -> CGTCGGGCGAA
GCGTCTTGACC -> CGTCTTGACCA
GCGTTGATTAT -> CGTTGATTATA
GCTAAGGTTTC -> CTAAGGTTTCG
GCTACAATCCT -> CTACAATCCTC
GCTACCCAGTA -> CTACCCAGTAA
GCTACCGGGTT -> CTACCGGGTTT
GCTACGGCCAT -> CTACGGCCATA
GCTAGCATTTC -> CTAGCATTTCC
GCTATAGTTAT -> CTATAGTTATC
GCTATGTCGGA -> CTATGTCGGAA
GCTCATTGCCA -> CTCATTGCCAA
GCTCATTGTGA -> CTCATTGTGAG
GCTCCGGACTC -> CTCCGGACTCT
GCTCCTTATAG -> CTCCTTATAGT
GCTCGATGAAT -> CTCGATGAATT
GCTCGTGCGGG -> CTCGTGCGGGA
GCTCTGACGAA -> CTCTGACGAAC
GCTCTGTGCAG -> CTCTGTGCAGG
GCTGACCTCCC -> CTGACCTCCCA
GCTGAGGCTAT -> CTGAGGCTATA
GCTGATTGCGC -> CTGATTGCGCG
GCTGCGAGCCG -> CTGCGAGCCGC
GCTGCTACCGG -> CTGCTACCGGG
GCTGCTGCTAC -> CTGCTGCTACC
GCTGTAGGTAC -> CTGTAGGTACT
GCTGTCATGTC -> CTGTCATGTCG
GCTGTCCGAAT -> CTGTCCGAATG
GCTGTCCTCGC -> CTGTCCTCGCT
GCTGTGAGACG -> CTGTGAGACGA
GCTTAGAGCAA -> CTTAGAGCAAT
GCTTCCCAACA -> CTTCCCAACAT
GCTTCGATCGA -> CTTCGATCGAC
GCTTGAAAGCC -> CTTGAAAGCCT
GCTTGAAAGTA -> CTTGAAAGTAA
GCTTGAGATGT -> CTTGAGATGTC
GCTTGCCGGTC -> CTTGCCGGTCC
GGAAAGCCCGA -> GAAAGCCCGAG
GGAAAGGGCAA -> GAAAGGGCAAT
GGAAATTAGTT -> GAAATTAGTTC
GGAAATTTAAG -> GAAATTTAAGG
GGAACACTGTC -> GAACACTGTCA
GGAACTCGGTA -> GAACTCGGTAA
GGAAGCTAAGG -> GAAGCTAAGGT
GGAAGCTGATT -> GAAGCTGATTG
GGAATGCACTC -> GAATGCACTCA
GGAATTGATTC -> GAATTGATTCC
GGAATTTACAG -> GAATTTACAGA
GGACAACCCGT -> GACAACCCGTG
GGACACGCGCG -> GACACGCGCGT
GGACCCGGTAC -> GACCCGGTACT
GGACGATGCTG -> GACGATGCTGA
GGACGTCGCCG -> GACGTCGCCGC
GGACTAGGTCA -> GACTAGGTCAC
GGACTCACTAC -> GACTCACTACT
GGACTCTACCG -> GACTCTACCGG
GGACTGCTCGT -> GACTGCTCGTG
GGAGCCACGGT -> GAGCCACGGTG
GGAGCGCACAA -> GAGCGCACAAT
GGAGGTAAGTG -> GAGGTAAGTGA
GGAGGTCTTAC -> GAGGTCTTACT
GGAGTACTAGA -> GAGTACTAGAG
GGATACTTCCA -> GATACTTCCAA
GGATCCAAGTG -> GATCCAAGTGA
GGATGATACTC -> GATGATACTCT
GGATGTTATTA -> GATGTTATTAA
GGCAAATATTG -> GCAAATATTGT
GGCAAGGTATC -> GCAAGGTATCC
GGCAATCAGAC -> GCAATCAGACG
GGCACGCAGGA -> GCACGCAGGAA
GGCACGGCAGC -> GCACGGCAGCT
GGCAGCTTGAA -> GCAGCTTGAAA
GGCAGGTGTAG -> GCAGGTGTAGA
GGCAGTCACGA -> GCAGTCACGAC
GGCATTGTAGG -> GCATTGTAGGC
GGCCATAGCTT -> GCCATAGCTTG
GGCCCAGCTTC -> GCCCAGCTTCC
GGCCCCTCTAA -> GCCCCTCTAAC
GGCCCTACCCA -> GCCCTACCCAT
GGCCTACGATG -> GCCTACGATGA
GGCCTACTCCA -> GCCTACTCCAG
GGCGAACACAT -> GCGAACACATT
GGCGAGTACCT -> GCGAGTACCTA
GGCTACCCAGT -> GCTACCCAGTA
GGCTATAGTTA -> GCTATAGTTAT
GGCTATGTCGG -> GCTATGTCGGA
GGCTCATTGCC -> GCTCATTGCCA
GGCTCCTTATA -> GCTCCTTATAG
GGCTCGATGAA -> GCTCGATGAAT
GGCTGACCTCC -> GCTGACCTCCC
GGCTGTCCTCG -> GCTGTCCTCGC
GGCTTAGAGCA -> GCTTAGAGCAA
GGCTTGAAAGT -> GCTTGAAAGTA
GGGACACGCGC -> GGACACGCGCG
GGGACCCGGTA -> GGACCCGGTAC
GGGACGTCGCC -> GGACGTCGCCG
GGGACTCACTA -> GGACTCACTAC
GGGACTGCTCG -> GGACTGCTCGT
GGGAGCCACGG -> GGAGCCACGGT
GGGAGTACTAG -> GGAGTACTAGA
GGGATGATACT -> GGATGATACTC
GGGATGTTATT -> GGATGTTATTA
GGGCAATCAGA -> GGCAATCAGAC
GGGCAGTCACG -> GGCAGTCACGA
GGGCCCTACCC -> GGCCCTACCCA
GGGCCTACGAT -> GGCCTACGATG
GGGCCTACTCC -> GGCCTACTCCA
GGGCGAACACA -> GGCGAACACAT
GGGCTCATTGC -> GGCTCATTGCC
GGGCTTAGAGC -> GGCTTAGAGCA
GGGGACGTCGC -> GGGACGTCGCC
GGGGCAGTCAC -> GGGCAGTCACG
GGGGCCTACGA -> GGGCCTACGAT
GGGGGACGTCG -> GGGGACGTCGC
GGGGGGTTGTA -> GGGGGTTGTAA
GGGGGTTGTAA -> GGGGTTGTAAT
GGGGTGCTAGC -> GGGTGCTAGCA
GGGGTTAAACC -> GGGTTAAACCC
GGGGTTGTAAT -> GGGTTGTAATT
GGGTGCTAGCA -> GGTGCTAGCAT
GGGTTAAACCC -> GGTTAAACCCG
GGGTTGTAATT -> GGTTGTAATTT
GGGTTTCTGAG -> GGTTTCTGAGA
GGTAAAAAGGC -> GTAAAAAGGCT
GGTAAGTGATC -> GTAAGTGATCG
GGTACCGACGC -> GTACCGACGCG
GGTACTACCTG -> GTACTACCTGG
GGTACTCCGTC -> GTACTCCGTCA
GGTATCCTCCT -> GTATCCTCCTG
GGTATGGAATT -> GTATGGAATTT
GGTATGTAGAC -> GTATGTAGACA
GGTCACATTGG -> GTCACATTGGG
GGTCATTTCTG -> GTCATTTCTGT
GGTCCCCGCTC -> GTCCCCGCTCT
GGTCCGTACGC -> GTCCGTACGCG
GGTCGTATACT -> GTCGTATACTC
GGTCTTACTGA -> GTCTTACTGAG
GGTGACTCAAT -> GTGACTCAATA
GGTGACTGAGT -> GTGACTGAGTG
GGTGATAAACG -> GTGATAAACGC
GGTGATCCCGA -> GTGATCCCGAC
GGTGCTAGCAT -> GTGCTAGCATT
GGTGTACACCA -> GTGTACACCAA
GGTGTAGATTG -> GTGTAGATTGC
GGTGTGACAGG -> GTGTGACAGGT
GGTTAAACCCG -> GTTAAACCCGT
GGTTAGAGGAG -> GTTAGAGGAGG
GGTTAGCCAGA -> GTTAGCCAGAA
GGTTCATTTCA -> GTTCATTTCAT
GGTTGGGACAC -> GTTGGGACACG
GGTTGTAATCA -> GTTGTAATCAG
GGTTGTAATTT -> GTTGTAATTTA
GGTTTCGGCTA -> GTTTCGGCTAC
GGTTTCTGAGA -> GTTTCTGAGAG
GGTTTTTCGCC -> GTTTTTCGCCA
GTAAAAAGGCT -> TAAAAAGGCTG
GTAAAAGCGGG -> TAAAAGCGGGG
GTAACCCGGTC -> TAACCCGGTCA
GTAACGGTATG -> TAACGGTATGG
GTAAGGGATGA -> TAAGGGATGAT
GTAAGTGATCG -> TAAGTGATCGC
GTAATCAGCCG -> TAATCAGCCGA
GTAATCCCTTA -> TAATCCCTTAA
GTAATCGAATG -> TAATCGAATGG
GTAATTTAAAT -> TAATTTAAATC
GTACACAACTC -> TACACAACTCC
GTACACCAATG -> TACACCAATGG
GTACCATCGGA -> TACCATCGGAA
GTACCGACGAG -> TACCGACGAGG
GTACCGACGCG -> TACCGACGCGC
GTACCTATAAA -> TACCTATAAAT
GTACGCGCTGT -> TACGCGCTGTC
GTACGTTCACG -> TACGTTCACGT
GTACTACCTGG -> TACTACCTGGC
GTACTAGAGCC -> TACTAGAGCCG
GTACTCCGTCA -> TACTCCGTCAC
GTACTGTCAAG -> TACTGTCAAGC
GTACTTTAAGC -> TACTTTAAGCG
GTAGACATGGG -> TAGACATGGGG
GTAGATTGCGT -> TAGATTGCGTC
GTAGCCGGGCT -> TAGCCGGGCTC
GTAGCTGCGAG -> TAGCTGCGAGC
GTAGGCGAGTA -> TAGGCGAGTAC
GTAGGTACTAC -> TAGGTACTACC
GTAGGTTAGCC -> TAGGTTAGCCA
GTATACTCACT -> TATACTCACTG
GTATAGTCAAA -> TATAGTCAAAC
GTATATTGGGA -> TATATTGGGAC
GTATCCTCCTG -> TATCCTCCTGC
GTATCGCAAAT -> TATCGCAAATC
GTATGACCCAT -> TATGACCCATA
GTATGGAATTT -> TATGGAATTTA
GTATGTAGACA -> TATGTAGACAT
GTCAAACACGG -> TCAAACACGGA
GTCAAGCCGCT -> TCAAGCCGCTG
GTCACATTGGG -> TCACATTGGGG
GTCACCGCTTC -> TCACCGCTTCG
GTCACCGTTAG -> TCACCGTTAGA
GTCACGACATC -> TCACGACATCA
GTCACTAAAAA -> TCACTAAAAAG
GTCATGTCGTT -> TCATGTCGTTC
GTCATTTCTGT -> TCATTTCTGTA
GTCATTTGAGA -> TCATTTGAGAT
GTCCACTAACT -> TCCACTAACTG
GTCCCAACTGC -> TCCCAACTGCG
GTCCCATACGT -> TCCCATACGTT
GTCCCCGCTCT -> TCCCCGCTCTG
GTCCCGCACCG -> TCCCGCACCGC
GTCCGAATGCG -> TCCGAATGCGA
GTCCGGACTAG -> TCCGGACTAGG
GTCCGTACGCG -> TCCGTACGCGC
GTCCTCGCTCA -> TCCTCGCTCAT
GTCCTTTAGGT -> TCCTTTAGGTT
GTCGAAGCCGT -> TCGAAGCCGTG
GTCGCAGAAGC -> TCGCAGAAGCC
GTCGCCGCGAG -> TCGCCGCGAGG
GTCGGAAAGCC -> TCGGAAAGCCC
GTCGGCTTGAA -> TCGGCTTGAAA
GTCGGGCGAAC -> TCGGGCGAACA
GTCGGGGGACG -> TCGGGGGACGT
GTCGTAGCCGG -> TCGTAGCCGGG
GTCGTATACTC -> TCGTATACTCA
GTCGTTCACTG -> TCGTTCACTGA
GTCTAATCATG -> TCTAATCATGC
GTCTCCGGATA -> TCTCCGGATAC
GTCTCGTACTT -> TCTCGTACTTT
GTCTGTCCACT -> TCTGTCCACTA
GTCTTACTGAG -> TCTTACTGAGT
GTCTTGACCAT -> TCTTGACCATA
GTGACAGGTCC -> TGACAGGTCCC
GTGACATCGCA -> TGACATCGCAG
GTGACTCAATA -> TGACTCAATAG
GTGACTGAGTG -> TGACTGAGTGT
GTGAGACGAGA -> TGAGACGAGAC
GTGAGCCAGAC -> TGAGCCAGACC
GTGAGGAGCGC -> TGAGGAGCGCA
GTGATAAACGC -> TGATAAACGCA
GTGATACTTGA -> TGATACTTGAT
GTGATAGATAG -> TGATAGATAGC
GTGATATGGCA -> TGATATGGCAA
GTGATCCCGAC -> TGATCCCGACT
GTGATCGCACA -> TGATCGCACAT
GTGCAGGGGTT -> TGCAGGGGTTA
GTGCCTGAATA -> TGCCTGAATAA
GTGCGGGACCC -> TGCGGGACCCG
GTGCTAGCATT -> TGCTAGCATTT
GTGGAAATTTA -> TGGAAATTTAA
GTGGAAGCTAA -> TGGAAGCTAAG
GTGGGCCCTAC -> TGGGCCCTACC
GTGTACACCAA -> TGTACACCAAT
GTGTAGATTGC -> TGTAGATTGCG
GTGTGACAGGT -> TGTGACAGGTC
GTGTTGCCAAT -> TGTTGCCAATT
GTTAAACCCGT -> TTAAACCCGTG
GTTAAGGGGTG -> TTAAGGGGTGC
GTTAGAGGAGG -> TTAGAGGAGGT
GTTAGATATTT -> TTAGATATTTT
GTTAGCCAGAA -> TTAGCCAGAAA
GTTATCCCTCG -> TTATCCCTCGC
GTTATTAAACG -> TTATTAAACGA
GTTCACGTATC -> TTCACGTATCG
GTTCACTGATT -> TTCACTGATTA
GTTCATTTCAT -> TTCATTTCATT
GTTCGCGTCGG -> TTCGCGTCGGG
GTTCTCTAATA -> TTCTCTAATAG
GTTCTGGTTTT -> TTCTGGTTTTT
GTTGATTATAG -> TTGATTATAGC
GTTGCCAATTA -> TTGCCAATTAC
GTTGGGACACG -> TTGGGACACGC
GTTGTAATCAG -> TTGTAATCAGC
GTTGTAATTTA -> TTGTAATTTAA
GTTGTACGTTC -> TTGTACGTTCA
GTTTCGAGTAA -> TTTCGAGTAAT
GTTTCGGCTAC -> TTTCGGCTACC
GTTTCTGAGAG -> TTTCTGAGAGA
GTTTGTCGAAG -> TTTGTCGAAGC
GTTTTCCCTCG -> TTTTCCCTCGG
GTTTTTCGCCA -> TTTTTCGCCAC
GTTTTTGGACG -> TTTTTGGACGA
TAAAAAGAAAT -> AAAAAGAAATG
TAAAAAGGCTG -> AAAAAGGCTGT
TAAAAGCGGGG -> AAAAGCGGGGG
TAAAAGTGATA -> AAAAGTGATAG
TAAACCCGTGA -> AAACCCGTGAG
TAAACGATGTA -> AAACGATGTAA
TAAACGCACGC -> AAACGCACGCT
TAAAGATTCCC -> AAAGATTCCCT
TAAATCTAAGG -> AAATCTAAGGC
TAAATGTGACA -> AAATGTGACAT
TAACCCGGTCA -> AACCCGGTCAT
TAACGATGTTT -> AACGATGTTTC
TAACGGGATGT -> AACGGGATGTT
TAACGGTATGG -> AACGGTATGGA
TAACTCCGAGG -> AACTCCGAGGT
TAACTCCTACG -> AACTCCTACGA
TAACTGCCTCG -> AACTGCCTCGA
TAAGAAAGTAC -> AAGAAAGTACT
TAAGCAGGTTG -> AAGCAGGTTGT
TAAGCCATTAG -> AAGCCATTAGC
TAAGCGTTGAT -> AAGCGTTGATT
TAAGGCATTGT -> AAGGCATTGTA
TAAGGGACTGC -> AAGGGACTGCT
TAAGGGATGAT -> AAGGGATGATA
TAAGGGGTGCT -> AAGGGGTGCTA
TAAGGTTTCGG -> AAGGTTTCGGC
TAAGTCGTAGC -> AAGTCGTAGCC
TAAGTGATCGC -> AAGTGATCGCA
TAAGTTCGCGT -> AAGTTCGCGTC
TAATAGTACCA -> AATAGTACCAT
TAATCAGCCGA -> AATCAGCCGAC
TAATCATGCTG -> AATCATGCTGT
TAATCCCTTAA -> AATCCCTTAAT
TAATCGAATGG -> AATCGAATGGA
TAATTGGTGAC -> AATTGGTGACT
TAATTTAAATC -> AATTTAAATCT
TACAATCCTCA -> ACAATCCTCAC
TACACAACTCC -> ACACAACTCCT
TACACCAATGG -> ACACCAATGGC
TACAGATCCGA -> ACAGATCCGAT
TACCATATGGC -> ACCATATGGCA
TACCATCGGAA -> ACCATCGGAAC
TACCCAGTAAG -> ACCCAGTAAGG
TACCCATGCAT -> ACCCATGCATA
TACCGACATTG -> ACCGACATTGT
TACCGACGAGG -> ACCGACGAGGA
TACCGACGCGC -> ACCGACGCGCG
TACCGGCACGC -> ACCGGCACGCA
TACCGGGTTTC -> ACCGGGTTTCT
TACCTAGCCGC -> ACCTAGCCGCG
TACCTATAAAT -> ACCTATAAATG
TACCTGGCCCC -> ACCTGGCCCCT
TACGATGAAAG -> ACGATGAAAGA
TACGATGTTCT -> ACGATGTTCTG
TACGCAAAAAT -> ACGCAAAAATA
TACGCAGTTTT -> ACGCAGTTTTC
TACGCGCTGTC -> ACGCGCTGTCC
TACGGCCATAG -> ACGGCCATAGC
TACGTTCACGT -> ACGTTCACGTA
TACGTTTGTCG -> ACGTTTGTCGA
TACTAACTCCG -> ACTAACTCCGA
TACTACCTGGC -> ACTACCTGGCC
TACTAGAGCCG -> ACTAGAGCCGT
TACTAGGGAGT -> ACTAGGGAGTA
TACTCAACAAG -> ACTCAACAAGA
TACTCACTGTA -> ACTCACTGTAG
TACTCCAGCTC -> ACTCCAGCTCT
TACTCCGTCAC -> ACTCCGTCACC
TACTCGGGAGC -> ACTCGGGAGCC
TACTCTTTCCG -> ACTCTTTCCGA
TACTGAGTTTT -> ACTGAGTTTTT
TACTGTCAAGC -> ACTGTCAAGCC
TACTTCCAAGT -> ACTTCCAAGTC
TACTTCGTCTG -> ACTTCGTCTGT
TACTTGATTGG -> ACTTGATTGGT
TACTTTAAGCG -> ACTTTAAGCGT
TACTTTGAATA -> ACTTTGAATAG
TAGACATGGGG -> AGACATGGGGC
TAGAGCAATAT -> AGAGCAATATA
TAGAGCCGTGG -> AGAGCCGTGGA
TAGAGGAGGTA -> AGAGGAGGTAA
TAGATAGCTCC -> AGATAGCTCCG
TAGATATTTTC -> AGATATTTTCC
TAGATTGCGTC -> AGATTGCGTCT
TAGCATTTCCT -> AGCATTTCCTT
TAGCCACTTAT -> AGCCACTTATT
TAGCCAGAAAG -> AGCCAGAAAGG
TAGCCGCGGTT -> AGCCGCGGTTC
TAGCCGGGCTC -> AGCCGGGCTCA
TAGCGCACGCT -> AGCGCACGCTA
TAGCTACGGCC -> AGCTACGGCCA
TAGCTCCGGAC -> AGCTCCGGACT
TAGCTGCGAGC -> AGCTGCGAGCC
TAGCTTGAGAT -> AGCTTGAGATG
TAGGAAATTAG -> AGGAAATTAGT
TAGGCGAGTAC -> AGGCGAGTACC
TAGGCTCCTTA -> AGGCTCCTTAT
TAGGGAGTACT -> AGGGAGTACTA
TAGGGCCTACT -> AGGGCCTACTC
TAGGTACTACC -> AGGTACTACCT
TAGGTCACATT -> AGGTCACATTG
TAGGTGACTCA -> AGGTGACTCAA
TAGGTTAGCCA -> AGGTTAGCCAG
TAGGTTGGGAC -> AGGTTGGGACA
TAGTACCATCG -> AGTACCATCGG
TAGTATAGTCA -> AGTATAGTCAA
TAGTCAAACAC -> AGTCAAACACG
TAGTCTCGTAC -> AGTCTCGTACT
TAGTTATCCCT -> AGTTATCCCTC
TAGTTCTCTAA -> AGTTCTCTAAT
TATAAATGTGA -> ATAAATGTGAC
TATAAGCCATT -> ATAAGCCATTA
TATACCATATG -> ATACCATATGG
TATACTCACTG -> ATACTCACTGT
TATAGCGCACG -> ATAGCGCACGC
TATAGTATAGT -> ATAGTATAGTC
TATAGTCAAAC -> ATAGTCAAACA
TATAGTTATCC -> ATAGTTATCCC
TATATTGGGAC -> ATATTGGGACT
TATCCCTCGCA -> ATCCCTCGCAC
TATCCTCCTGC -> ATCCTCCTGCG
TATCGCAAATC -> ATCGCAAATCT
TATGACCCATA -> ATGACCCATAA
TATGGAATTTA -> ATGGAATTTAC
TATGGCAAATA -> ATGGCAAATAT
TATGGCAAGGT -> ATGGCAAGGTA
TATGTAGACAT -> ATGTAGACATG
TATGTCGGAAA -> ATGTCGGAAAG
TATTAAACGAT -> ATTAAACGATG
TATTAAGTTCG -> ATTAAGTTCGC
TATTGGGACTC -> ATTGGGACTCA
TATTGTAACGG -> ATTGTAACGGT
TATTTTCCCCG -> ATTTTCCCCGT
TCAAACACGGA -> CAAACACGGAA
TCAACAAGAGC -> CAACAAGAGCC
TCAAGCCGCTG -> CAAGCCGCTGT
TCAATAGGGCC -> CAATAGGGCCT
TCACATTGGGG -> CACATTGGGGC
TCACCAGAATG -> CACCAGAATGA
TCACCCGACAG -> CACCCGACAGT
TCACCGCTTCG -> CACCGCTTCGA
TCACCGTTAGA -> CACCGTTAGAT
TCACGACATCA -> CACGACATCAG
TCACGGCTGAC -> CACGGCTGACC
TCACGTATCGC -> CACGTATCGCA
TCACTAAAAAG -> CACTAAAAAGA
TCACTACTCGG -> CACTACTCGGG
TCACTACTTCG -> CACTACTTCGT
TCACTGATTAC -> CACTGATTACG
TCACTGTAGGT -> CACTGTAGGTT
TCAGACGATAC -> CAGACGATACT
TCAGCCGACCG -> CAGCCGACCGT
TCAGTCCTTTA -> CAGTCCTTTAG
TCATCCGTTGT -> CATCCGTTGTA
TCATGCTGTCA -> CATGCTGTCAT
TCATGTCGTTC -> CATGTCGTTCA
TCATTCACCAG -> CATTCACCAGA
TCATTGCCAAC -> CATTGCCAACT
TCATTGTACCG -> CATTGTACCGA
TCATTGTGAGC -> CATTGTGAGCC
TCATTTCATTG -> CATTTCATTGT
TCATTTCTGTA -> CATTTCTGTAC
TCATTTGAGAT -> CATTTGAGATA
TCCAAGTCCGG -> CCAAGTCCGGA
TCCAAGTGATA -> CCAAGTGATAT
TCCACTAACTG -> CCACTAACTGC
TCCAGCTCTGA -> CCAGCTCTGAC
TCCCAACATTG -> CCCAACATTGC
TCCCAACTGCG -> CCCAACTGCGT
TCCCACACTGG -> CCCACACTGGT
TCCCATACGTT -> CCCATACGTTT
TCCCCGACACC -> CCCCGACACCG
TCCCCGCTCTG -> CCCCGCTCTGT
TCCCCGTCTAA -> CCCCGTCTAAT
TCCCGACTCAC -> CCCGACTCACT
TCCCGCACCGC -> CCCGCACCGCG
TCCCTCGCACA -> CCCTCGCACAC
TCCCTCGGCCC -> CCCTCGGCCCA
TCCCTTAATTG -> CCCTTAATTGG
TCCCTTCCTCT -> CCCTTCCTCTG
TCCGAATGCGA -> CCGAATGCGAT
TCCGACCAAGC -> CCGACCAAGCA
TCCGAGGTCGT -> CCGAGGTCGTA
TCCGATGATAC -> CCGATGATACG
TCCGGACTAGG -> CCGGACTAGGT
TCCGGACTCTA -> CCGGACTCTAC
TCCGGATACTT -> CCGGATACTTC
TCCGTACGCGC -> CCGTACGCGCT
TCCGTCACCGT -> CCGTCACCGTT
TCCGTTGTACG -> CCGTTGTACGT
TCCTACGATGT -> CCTACGATGTT
TCCTAGGCTCC -> CCTAGGCTCCT
TCCTCACCCGA -> CCTCACCCGAC
TCCTCCTGCGT -> CCTCCTGCGTC
TCCTCGCTCAT -> CCTCGCTCATT
TCCTCTGTAGC -> CCTCTGTAGCT
TCCTGCGTCAC -> CCTGCGTCACT
TCCTTATAGTA -> CCTTATAGTAT
TCCTTGATACC -> CCTTGATACCT
TCCTTTAGGTT -> CCTTTAGGTTG
TCCTTTTTGTC -> CCTTTTTGTCC
TCGAAGCCGTG -> CGAAGCCGTGG
TCGAATGGAAA -> CGAATGGAAAG
TCGACGTCTCC -> CGACGTCTCCG
TCGAGCTTGCC -> CGAGCTTGCCG
TCGAGTAATCG -> CGAGTAATCGA
TCGATCGACGT -> CGATCGACGTC
TCGATGAATTC -> CGATGAATTCA
TCGCAAATCTG -> CGCAAATCTGT
TCGCACACTAT -> CGCACACTATA
TCGCACATTAC -> CGCACATTACC
TCGCAGAAGCC -> CGCAGAAGCCG
TCGCAGGTTAG -> CGCAGGTTAGA
TCGCCACAACC -> CGCCACAACCT
TCGCCGCGAGG -> CGCCGCGAGGT
TCGCGTCGGGC -> CGCGTCGGGCG
TCGCTCATTGT -> CGCTCATTGTG
TCGGAAAGCCC -> CGGAAAGCCCG
TCGGAACTCGG -> CGGAACTCGGT
TCGGCCCAGCT -> CGGCCCAGCTT
TCGGCTACCCA -> CGGCTACCCAG
TCGGCTTGAAA -> CGGCTTGAAAG
TCGGGAGCCAC -> CGGGAGCCACG
TCGGGCGAACA -> CGGGCGAACAC
TCGGGGGACGT -> CGGGGGACGTC
TCGGTAAAAAG -> CGGTAAAAAGG
TCGTACTTTAA -> CGTACTTTAAG
TCGTAGCCGGG -> CGTAGCCGGGC
TCGTATACTCA -> CGTATACTCAC
TCGTCTGTCCA -> CGTCTGTCCAC
TCGTGCGGGAC -> CGTGCGGGACC
TCGTTCACTGA -> CGTTCACTGAT
TCTAACGATGT -> CTAACGATGTT
TCTAAGCAGGT -> CTAAGCAGGTT
TCTAAGGCATT -> CTAAGGCATTG
TCTAATAGTAC -> CTAATAGTACC
TCTAATCATGC -> CTAATCATGCT
TCTACCGGCAC -> CTACCGGCACG
TCTCCGGATAC -> CTCCGGATACT
TCTCGTACTTT -> CTCGTACTTTA
TCTCTAAGCAG -> CTCTAAGCAGG
TCTCTAATAGT -> CTCTAATAGTA
TCTGACGAACA -> CTGACGAACAC
TCTGAGAGACT -> CTGAGAGACTA
TCTGGTTTTTC -> CTGGTTTTTCG
TCTGTACACAA -> CTGTACACAAC
TCTGTAGCTGC -> CTGTAGCTGCG
TCTGTCCACTA -> CTGTCCACTAA
TCTGTGCAGGG -> CTGTGCAGGGG
TCTGTGGGCCC -> CTGTGGGCCCT
TCTTACTGAGT -> CTTACTGAGTT
TCTTGACCATA -> CTTGACCATAA
TCTTTCCGACC -> CTTTCCGACCA
TGAAAGATTGT -> GAAAGATTGTG
TGAAAGCCTTT -> GAAAGCCTTTG
TGAAAGTAACC -> GAAAGTAACCC
TGAATAAGAAA -> GAATAAGAAAG
TGAATAGTCTC -> GAATAGTCTCG
TGAATTCATCC -> GAATTCATCCG
TGACAGGTCCC -> GACAGGTCCCC
TGACATCGCAG -> GACATCGCAGG
TGACCATAACT -> GACCATAACTC
TGACCCATAAA -> GACCCATAAAA
TGACCTCCCAC -> GACCTCCCACA
TGACGAACACG -> GACGAACACGT
TGACTCAATAG -> GACTCAATAGG
TGACTCTCTAA -> GACTCTCTAAG
TGACTGAGTGT -> GACTGAGTGTT
TGAGAACAGCC -> GAGAACAGCCA
TGAGACGAGAC -> GAGACGAGACG
TGAGAGACTAG -> GAGAGACTAGC
TGAGATAGGAA -> GAGATAGGAAA
TGAGATGTCCC -> GAGATGTCCCA
TGAGCCAGACC -> GAGCCAGACCA
TGAGGAGCGCA -> GAGGAGCGCAC
TGAGGCTATAG -> GAGGCTATAGT
TGAGTGTTGCC -> GAGTGTTGCCA
TGAGTTTTTGG -> GAGTTTTTGGA
TGATAAACGCA -> GATAAACGCAC
TGATACCTAGC -> GATACCTAGCC
TGATACGCAAA -> GATACGCAAAA
TGATACTCTTT -> GATACTCTTTC
TGATACTTGAT -> GATACTTGATT
TGATAGATAGC -> GATAGATAGCT
TGATATGGCAA -> GATATGGCAAG
TGATCCCGACT -> GATCCCGACTC
TGATCGCACAT -> GATCGCACATT
TGATTACGCAG -> GATTACGCAGT
TGATTATAGCG -> GATTATAGCGC
TGATTCCCCGA -> GATTCCCCGAC
TGATTGCGCGC -> GATTGCGCGCT
TGATTGGTGAT -> GATTGGTGATC
TGATTTCCTTT -> GATTTCCTTTT
TGCACTCATTC -> GCACTCATTCA
TGCAGGGGTTA -> GCAGGGGTTAA
TGCATAAGTCG -> GCATAAGTCGT
TGCCAACTAAA -> GCCAACTAAAG
TGCCAATTACT -> GCCAATTACTA
TGCCGGTCCGT -> GCCGGTCCGTA
TGCCTCGAGCT -> GCCTCGAGCTT
TGCCTGAATAA -> GCCTGAATAAG
TGCGAGCCGCG -> GCGAGCCGCGT
TGCGATGAGAA -> GCGATGAGAAC
TGCGCGCTGCT -> GCGCGCTGCTG
TGCGGGACCCG -> GCGGGACCCGG
TGCGTAAAAGC -> GCGTAAAAGCG
TGCGTCACTAA -> GCGTCACTAAA
TGCGTCTTGAC -> GCGTCTTGACC
TGCTACCGGGT -> GCTACCGGGTT
TGCTAGCATTT -> GCTAGCATTTC
TGCTCGTGCGG -> GCTCGTGCGGG
TGCTGAGGCTA -> GCTGAGGCTAT
TGCTGCTACCG -> GCTGCTACCGG
TGCTGTCATGT -> GCTGTCATGTC
TGGAAAGGGCA -> GGAAAGGGCAA
TGGAAATTTAA -> GGAAATTTAAG
TGGAAGCTAAG -> GGAAGCTAAGG
TGGAATTTACA -> GGAATTTACAG
TGGACGATGCT -> GGACGATGCTG
TGGCAAATATT -> GGCAAATATTG
TGGCAAGGTAT -> GGCAAGGTATC
TGGCAGGTGTA -> GGCAGGTGTAG
TGGCCCCTCTA -> GGCCCCTCTAA
TGGCTATGTCG -> GGCTATGTCGG
TGGGACACGCG -> GGGACACGCGC
TGGGACTCACT -> GGGACTCACTA
TGGGCCCTACC -> GGGCCCTACCC
TGGGCTTAGAG -> GGGCTTAGAGC
TGGGGCAGTCA -> GGGGCAGTCAC
TGGGGCCTACG -> GGGGCCTACGA
TGGTACCGACG -> GGTACCGACGC
TGGTGACTGAG -> GGTGACTGAGT
TGGTGATAAAC -> GGTGATAAACG
TGGTGATCCCG -> GGTGATCCCGA
TGGTGTACACC -> GGTGTACACCA
TGGTTTTTCGC -> GGTTTTTCGCC
TGTAACGGTAT -> GTAACGGTATG
TGTAATCAGCC -> GTAATCAGCCG
TGTAATCCCTT -> GTAATCCCTTA
TGTAATTTAAA -> GTAATTTAAAT
TGTACACAACT -> GTACACAACTC
TGTACACCAAT -> GTACACCAATG
TGTACCGACGA -> GTACCGACGAG
TGTACGTTCAC -> GTACGTTCACG
TGTAGACATGG -> GTAGACATGGG
TGTAGATTGCG -> GTAGATTGCGT
TGTAGCTGCGA -> GTAGCTGCGAG
TGTAGGCGAGT -> GTAGGCGAGTA
TGTAGGTACTA -> GTAGGTACTAC
TGTAGGTTAGC -> GTAGGTTAGCC
TGTCAAGCCGC -> GTCAAGCCGCT
TGTCATGTCGT -> GTCATGTCGTT
TGTCATTTGAG -> GTCATTTGAGA
TGTCCACTAAC -> GTCCACTAACT
TGTCCCAACTG -> GTCCCAACTGC
TGTCCCATACG -> GTCCCATACGT
TGTCCGAATGC -> GTCCGAATGCG
TGTCCTCGCTC -> GTCCTCGCTCA
TGTCGAAGCCG -> GTCGAAGCCGT
TGTCGGAAAGC -> GTCGGAAAGCC
TGTCGGGGGAC -> GTCGGGGGACG
TGTCGTTCACT -> GTCGTTCACTG
TGTGACAGGTC -> GTGACAGGTCC
TGTGACATCGC -> GTGACATCGCA
TGTGAGACGAG -> GTGAGACGAGA
TGTGAGCCAGA -> GTGAGCCAGAC
TGTGATACTTG -> GTGATACTTGA
TGTGCAGGGGT -> GTGCAGGGGTT
TGTGGGCCCTA -> GTGGGCCCTAC
TGTTATTAAAC -> GTTATTAAACG
TGTTCTGGTTT -> GTTCTGGTTTT
TGTTGCCAATT -> GTTGCCAATTA
TGTTTCGAGTA -> GTTTCGAGTAA
TTAAACCCGTG -> TAAACCCGTGA
TTAAACGATGT -> TAAACGATGTA
TTAAATCTAAG -> TAAATCTAAGG
TTAACGGGATG -> TAACGGGATGT
TTAAGCGTTGA -> TAAGCGTTGAT
TTAAGGGACTG -> TAAGGGACTGC
TTAAGGGGTGC -> TAAGGGGTGCT
TTAAGTTCGCG -> TAAGTTCGCGT
TTAATTGGTGA -> TAATTGGTGAC
TTACAGATCCG -> TACAGATCCGA
TTACCGACATT -> TACCGACATTG
TTACGCAGTTT -> TACGCAGTTTT
TTACTAGGGAG -> TACTAGGGAGT
TTACTGAGTTT -> TACTGAGTTTT
TTACTTTGAAT -> TACTTTGAATA
TTAGAGCAATA -> TAGAGCAATAT
TTAGAGGAGGT -> TAGAGGAGGTA
TTAGATATTTT -> TAGATATTTTC
TTAGCCAGAAA -> TAGCCAGAAAG
TTAGCTACGGC -> TAGCTACGGCC
TTAGGTGACTC -> TAGGTGACTCA
TTAGGTTGGGA -> TAGGTTGGGAC
TTAGTTCTCTA -> TAGTTCTCTAA
TTATAGCGCAC -> TATAGCGCACG
TTATAGTATAG -> TATAGTATAGT
TTATCCCTCGC -> TATCCCTCGCA
TTATTAAACGA -> TATTAAACGAT
TTATTAAGTTC -> TATTAAGTTCG
TTCACCAGAAT -> TCACCAGAATG
TTCACGTATCG -> TCACGTATCGC
TTCACTGATTA -> TCACTGATTAC
TTCATCCGTTG -> TCATCCGTTGT
TTCATTGTACC -> TCATTGTACCG
TTCATTTCATT -> TCATTTCATTG
TTCCAAGTCCG -> TCCAAGTCCGG
TTCCCAACATT -> TCCCAACATTG
TTCCCCGACAC -> TCCCCGACACC
TTCCCCGTCTA -> TCCCCGTCTAA
TTCCCTCGGCC -> TCCCTCGGCCC
TTCCCTTCCTC -> TCCCTTCCTCT
TTCCGACCAAG -> TCCGACCAAGC
TTCCTCTGTAG -> TCCTCTGTAGC
TTCCTTGATAC -> TCCTTGATACC
TTCCTTTTTGT -> TCCTTTTTGTC
TTCGAGTAATC -> TCGAGTAATCG
TTCGATCGACG -> TCGATCGACGT
TTCGCCACAAC -> TCGCCACAACC
TTCGCGTCGGG -> TCGCGTCGGGC
TTCGGCTACCC -> TCGGCTACCCA
TTCGTCTGTCC -> TCGTCTGTCCA
TTCTCTAATAG -> TCTCTAATAGT
TTCTGAGAGAC -> TCTGAGAGACT
TTCTGGTTTTT -> TCTGGTTTTTC
TTCTGTACACA -> TCTGTACACAA
TTGAAAGCCTT -> TGAAAGCCTTT
TTGAAAGTAAC -> TGAAAGTAACC
TTGAATAGTCT -> TGAATAGTCTC
TTGACCATAAC -> TGACCATAACT
TTGAGATAGGA -> TGAGATAGGAA
TTGAGATGTCC -> TGAGATGTCCC
TTGATACCTAG -> TGATACCTAGC
TTGATTATAGC -> TGATTATAGCG
TTGATTCCCCG -> TGATTCCCCGA
TTGATTGGTGA -> TGATTGGTGAT
TTGATTTCCTT -> TGATTTCCTTT
TTGCCAACTAA -> TGCCAACTAAA
TTGCCAATTAC -> TGCCAATTACT
TTGCCGGTCCG -> TGCCGGTCCGT
TTGCGCGCTGC -> TGCGCGCTGCT
TTGCGTCTTGA -> TGCGTCTTGAC
TTGGACGATGC -> TGGACGATGCT
TTGGGACACGC -> TGGGACACGCG
TTGGGACTCAC -> TGGGACTCACT
TTGGGCTTAGA -> TGGGCTTAGAG
TTGGGGCCTAC -> TGGGGCCTACG
TTGGTGACTGA -> TGGTGACTGAG
TTGGTGATCCC -> TGGTGATCCCG
TTGGTGTACAC -> TGGTGTACACC
TTGTAACGGTA -> TGTAACGGTAT
TTGTAATCAGC -> TGTAATCAGCC
TTGTAATTTAA -> TGTAATTTAAA
TTGTACCGACG -> TGTACCGACGA
TTGTACGTTCA -> TGTACGTTCAC
TTGTAGGCGAG -> TGTAGGCGAGT
TTGTCCCATAC -> TGTCCCATACG
TTGTCGAAGCC -> TGTCGAAGCCG
TTGTCGGGGGA -> TGTCGGGGGAC
TTGTGAGCCAG -> TGTGAGCCAGA
TTGTGATACTT -> TGTGATACTTG
TTTAAATCTAA -> TTAAATCTAAG
TTTAACGGGAT -> TTAACGGGATG
TTTAAGCGTTG -> TTAAGCGTTGA
TTTAAGGGACT -> TTAAGGGACTG
TTTACAGATCC -> TTACAGATCCG
TTTAGGTTGGG -> TTAGGTTGGGA
TTTCATTGTAC -> TTCATTGTACC
TTTCCCCGTCT -> TTCCCCGTCTA
TTTCCCTCGGC -> TTCCCTCGGCC
TTTCCGACCAA -> TTCCGACCAAG
TTTCCTTGATA -> TTCCTTGATAC
TTTCCTTTTTG -> TTCCTTTTTGT
TTTCGAGTAAT -> TTCGAGTAATC
TTTCGCCACAA -> TTCGCCACAAC
TTTCGGCTACC -> TTCGGCTACCC
TTTCTGAGAGA -> TTCTGAGAGAC
TTTCTGTACAC -> TTCTGTACACA
TTTGAATAGTC -> TTGAATAGTCT
TTTGAGATAGG -> TTGAGATAGGA
TTTGGACGATG -> TTGGACGATGC
TTTGGGCTTAG -> TTGGGCTTAGA
TTTGTCCCATA -> TTGTCCCATAC
TTTGTCGAAGC -> TTGTCGAAGCC
TTTTCCCCGTC -> TTTCCCCGTCT
TTTTCCCTCGG -> TTTCCCTCGGC
TTTTCGCCACA -> TTTCGCCACAA
TTTTGGACGAT -> TTTGGACGATG
TTTTGTCCCAT -> TTTGTCCCATA
TTTTTCGCCAC -> TTTTCGCCACA
TTTTTGGACGA -> TTTTGGACGAT
TTTTTGTCCCA -> TTTTGTCCCAT