AAAAACGTAAC -> AAAACGTAACC
AAAACCAGATG -> AAACCAGATGA
AAAACGTAACC -> AAACGTAACCG
AAAAGATGAAG -> AAAGATGAAGA
AAAAGGTGTGA -> AAAGGTGTGAT
AAAAGTCAAAA -> AAAGTCAAAAG
AAAAGTTTACT -> AAAGTTTACTA
AAAATCATCGA -> AAATCATCGAG
AAACAAAGCGT -> AACAAAGCGTG
AAACACAAGTA -> AACACAAGTAG
AAACACTCGAC -> AACACTCGACT
AAACAGACACT -> AACAGACACTT
AAACCAGATGA -> AACCAGATGAG
AAACCCGTAAC -> AACCCGTAACT
AAACCTGCAGG -> AACCTGCAGGT
AAACGCGCCGT -> AACGCGCCGTA
AAACGTAACCG -> AACGTAACCGG
AAACTTCCATA -> AACTTCCATAC
AAAGATGAAGA -> AAGATGAAGAC
AAAGATTTCAA -> AAGATTTCAAC
AAAGCGTGCGA -> AAGCGTGCGAC
AAAGGAGCGCA -> AAGGAGCGCAG
AAAGGCCAGGA -> AAGGCCAGGAA
AAAGGGGTCTC -> AAGGGGTCTCC
AAAGGTATGGC -> AAGGTATGGCA
AAAGGTGTGAT -> AAGGTGTGATC
AAAGTCAAAAG -> AAGTCAAAAGA
AAAGTTTACTA -> AAGTTTACTAC
AAATACGAACC -> AATACGAACCA
AAATACTATAG -> AATACTATAGT
AAATAGAGTAG -> AATAGAGTAGC
AAATCATCGAG -> AATCATCGAGA
AAATGACCAAT -> AATGACCAATG
AAATTCCAGTT -> AATTCCAGTTA
AAATTTTTCAT -> AATTTTTCATA
AACAAAGCGTG -> ACAAAGCGTGC
AACAAAGGTAT -> ACAAAGGTATG
AACACAAGTAG -> ACACAAGTAGC
AACACACCAGC -> ACACACCAGCG
AACACTCGACT -> ACACTCGACTC
AACACTTTGAT -> ACACTTTGATT
AACAGAATCTA -> ACAGAATCTAT
AACAGACACTT -> ACAGACACTTG
AACAGGCTAGG -> ACAGGCTAGGA
AACATAGGATT -> ACATAGGATTC
AACATCGTCCG -> ACATCGTCCGG
AACATTACATC -> ACATTACATCC
AACCAGAAACT -> ACCAGAAACTT
AACCAGATGAG -> ACCAGATGAGG
AACCATCCGCC -> ACCATCCGCCG
AACCCGGCAAT -> ACCCGGCAATT
AACCCGTAACT -> ACCCGTAACTG
AACCGGGCTCT -> ACCGGGCTCTC
AACCGGTACTC -> ACCGGTACTCT
AACCTGCAGGT -> ACCTGCAGGTG
AACGCGCCGTA -> ACGCGCCGTAC
AACGGCTCATT -> ACGGCTCATTG
AACGTAACCGG -> ACGTAACCGGG
AACGTAGACGA -> ACGTAGACGAG
AACTACCAAGA -> ACTACCAAGAG
AACTAGTACAA -> ACTAGTACAAC
AACTGCCACAT -> ACTGCCACATC
AACTTCCATAC -> ACTTCCATACC
AACTTGGCGCT -> ACTTGGCGCTA
AAGAAAGGAGC -> AGAAAGGAGCG
AAGAAATTCCA -> AGAAATTCCAG
AAGACCAAACA -> AGACCAAACAC
AAGACCTTCAT -> AGACCTTCATA
AAGACGGCTCC -> AGACGGCTCCA
AAGACTCCAAT -> AGACTCCAATG
AAGAGACTAAA -> AGAGACTAAAC
AAGATAGCAGG -> AGATAGCAGGG
AAGATGAAGAC -> AGATGAAGACC
AAGATGACTGA -> AGATGACTGAC
AAGATTTCAAC -> AGATTTCAACA
AAGCCGTGCAT -> AGCCGTGCATT
AAGCGAATACC -> AGCGAATACCA
AAGCGATCGTA -> AGCGATCGTAA
AAGCGTGCGAC -> AGCGTGCGACG
AAGCTAAACGC -> AGCTAAACGCG
AAGCTACTATC -> AGCTACTATCT
AAGCTGAACGG -> AGCTGAACGGC
AAGGAAGAAAT -> AGGAAGAAATT
AAGGAGCGCAG -> AGGAGCGCAGT
AAGGAGGGATC -> AGGAGGGATCG
AAGGCCAGGAA -> AGGCCAGGAAT
AAGGCTCGTCC -> AGGCTCGTCCA
AAGGGCGGCGG -> AGGGCGGCGGC
AAGGGGTCTCC -> AGGGGTCTCCA
AAGGTATGGCA -> AGGTATGGCAA
AAGGTGTGATC -> AGGTGTGATCG
AAGTACCATTG -> AGTACCATTGC
AAGTAGCACGT -> AGTAGCACGTT
AAGTATGTGCG -> AGTATGTGCGT
AAGTCAAAAGA -> AGTCAAAAGAT
AAGTCCTTTAA -> AGTCCTTTAAA
AAGTGCTCAGT -> AGTGCTCAGTC
AAGTGGCCGAT -> AGTGGCCGATA
AAGTTAAACAA -> AGTTAAACAAA
AAGTTTACTAC -> AGTTTACTACG
AATACCATTCC -> ATACCATTCCT
AATACGAACCA -> ATACGAACCAT
AATACTATAGT -> ATACTATAGTT
AATACTTTGTA -> ATACTTTGTAC
AATAGAGTAGC -> ATAGAGTAGCA
AATAGGAAACC -> ATAGGAAACCC
AATCACCACGT -> ATCACCACGTA
AATCACCACTA -> ATCACCACTAG
AATCATCGAGA -> ATCATCGAGAC
AATCCTCGTTC -> ATCCTCGTTCT
AATCGGCAAAG -> ATCGGCAAAGG
AATCTATGTGT -> ATCTATGTGTA
AATGAAGAAAG -> ATGAAGAAAGG
AATGACCAATG -> ATGACCAATGG
AATGAGCTCCG -> ATGAGCTCCGC
AATGCATGTCT -> ATGCATGTCTA
AATGGCCGCTA -> ATGGCCGCTAG
AATGGGAGGCA -> ATGGGAGGCAC
AATGGGTGGAG -> ATGGGTGGAGC
AATGTAGCTGC -> ATGTAGCTGCT
AATTAACTAGT -> ATTAACTAGTA
AATTAAGTGGC -> ATTAAGTGGCC
AATTACGGACA -> ATTACGGACAA
AATTACTAGCG -> ATTACTAGCGC
AATTCACACGA -> ATTCACACGAG
AATTCCAGTTA -> ATTCCAGTTAA
AATTCTCGGTT -> ATTCTCGGTTT
AATTCTGATCT -> ATTCTGATCTT
AATTGGTTTGA -> ATTGGTTTGAA
AATTTAATCAC -> ATTTAATCACC
AATTTTTCATA -> ATTTTTCATAG
ACAAAGCGTGC -> CAAAGCGTGCG
ACAAAGGCCAG -> CAAAGGCCAGG
ACAAAGGTATG -> CAAAGGTATGG
ACAAATTTTTC -> CAAATTTTTCA
ACAACAGAATC -> CAACAGAATCT
ACAACATAGGA -> CAACATAGGAT
ACAAGGGCGGC -> CAAGGGCGGCG
ACAAGTAGCAC -> CAAGTAGCACG
ACACAAGTAGC -> CACAAGTAGCA
ACACACCAGCG -> CACACCAGCGC
ACACACGAAAC -> CACACGAAACA
ACACACTCAAG -> CACACTCAAGC
ACACAGCCATA -> CACAGCCATAT
ACACATACCTG -> CACATACCTGT
ACACCAGCGCA -> CACCAGCGCAA
ACACCTAAGCT -> CACCTAAGCTA
ACACGAAACAC -> CACGAAACACA
ACACGAGGGGA -> CACGAGGGGAT
ACACGGGTCGG -> CACGGGTCGGG
ACACTCAAGCT -> CACTCAAGCTG
ACACTCGACTC -> CACTCGACTCG
ACACTTGAAGA -> CACTTGAAGAC
ACACTTTGATT -> CACTTTGATTC
ACAGAATCTAT -> CAGAATCTATG
ACAGACACTTG -> CAGACACTTGA
ACAGATGGTAT -> CAGATGGTATT
ACAGATGTTTG -> CAGATGTTTGT
ACAGCCATATC -> CAGCCATATCT
ACAGGCTAGGA -> CAGGCTAGGAC
ACATACCTGTA -> CATACCTGTAC
ACATAGGATTC -> CATAGGATTCG
ACATAGGTACA -> CATAGGTACAT
ACATATATGGC -> CATATATGGCA
ACATCAGTCTC -> CATCAGTCTCG
ACATCCGGGAT -> CATCCGGGATC
ACATCGTCCGG -> CATCGTCCGGC
ACATTAATCAC -> CATTAATCACC
ACATTACATCC -> CATTACATCCG
ACATTTCAATT -> CATTTCAATTA
ACCAAACACTC -> CCAAACACTCG
ACCAACAGGCT -> CCAACAGGCTA
ACCAAGAGACT -> CCAAGAGACTA
ACCAATCCTCG -> CCAATCCTCGT
ACCAATGGGAG -> CCAATGGGAGG
ACCACGTAGAA -> CCACGTAGAAC
ACCACTAGATG -> CCACTAGATGA
ACCAGAAACTT -> CCAGAAACTTC
ACCAGAGTTTA -> CCAGAGTTTAA
ACCAGATGAGG -> CCAGATGAGGA
ACCAGATGGCA -> CCAGATGGCAA
ACCAGCGCAAA -> CCAGCGCAAAA
ACCATCCGCCG -> CCATCCGCCGA
ACCATTCCTAT -> CCATTCCTATC
ACCATTGCTGC -> CCATTGCTGCA
ACCCAACCCGG -> CCCAACCCGGC
ACCCACTCCGG -> CCCACTCCGGC
ACCCCCTGCGA -> CCCCCTGCGAT
ACCCGGCAATT -> CCCGGCAATTC
ACCCGTAACTG -> CCCGTAACTGC
ACCCTCACGAC -> CCCTCACGACT
ACCCTCAGTCC -> CCCTCAGTCCT
ACCCTCGGACC -> CCCTCGGACCC
ACCCTTCAATG -> CCCTTCAATGA
ACCGATCAGAA -> CCGATCAGAAT
ACCGGGCTCTC -> CCGGGCTCTCC
ACCGGTACTCT -> CCGGTACTCTT
ACCGGTTCCAC -> CCGGTTCCACA
ACCGTCGTAGG -> CCGTCGTAGGT
ACCTAAGCTAC -> CCTAAGCTACT
ACCTCGAGTTA -> CCTCGAGTTAA
ACCTGCAGGTG -> CCTGCAGGTGG
ACCTGCATACG -> CCTGCATACGA
ACCTGGCCGTC -> CCTGGCCGTCT
ACCTGTACGGT -> CCTGTACGGTC
ACCTTATAATT -> CCTTATAATTC
ACCTTCATAGC -> CCTTCATAGCG
ACGAAACACAA -> CGAAACACAAG
ACGAACCATCC -> CGAACCATCCG
ACGAATGTAGC -> CGAATGTAGCT
ACGAATTAACT -> CGAATTAACTA
ACGACTGATGG -> CGACTGATGGT
ACGAGAACTTG -> CGAGAACTTGG
ACGAGGGGATC -> CGAGGGGATCC
ACGATTCTCCG -> CGATTCTCCGG
ACGATTCTTCC -> CGATTCTTCCA
ACGCGCCGTAC -> CGCGCCGTACG
ACGGACAAAGG -> CGGACAAAGGC
ACGGCCCGAGG -> CGGCCCGAGGC
ACGGCTCATTG -> CGGCTCATTGG
ACGGCTCCATC -> CGGCTCCATCT
ACGGGTCGGGT -> CGGGTCGGGTT
ACGGTATTCGA -> CGGTATTCGAC
ACGGTCACATA -> CGGTCACATAT
ACGTAACCGGG -> CGTAACCGGGC
ACGTACCAACA -> CGTACCAACAG
ACGTAGAACAA -> CGTAGAACAAA
ACGTAGACGAG -> CGTAGACGAGA
ACGTAGCGTAC -> CGTAGCGTACA
ACGTGTAGACT -> CGTGTAGACTA
ACGTTATAAAA -> CGTTATAAAAA
ACGTTTCTGAC -> CGTTTCTGACC
ACTAAAAGGTG -> CTAAAAGGTGT
ACTAAACCTGC -> CTAAACCTGCA
ACTAAGGAAGA -> CTAAGGAAGAA
ACTACCAAGAG -> CTACCAAGAGA
ACTACGTGTAG -> CTACGTGTAGA
ACTAGATGAGA -> CTAGATGAGAC
ACTAGCGCTGC -> CTAGCGCTGCG
ACTAGTACAAC -> CTAGTACAACA
ACTATAAGACC -> CTATAAGACCT
ACTATAGTTGT -> CTATAGTTGTT
ACTATCCGGGT -> CTATCCGGGTA
ACTATCTTATT -> CTATCTTATTA
ACTATTTATTC -> CTATTTATTCG
ACTCAAGCTGA -> CTCAAGCTGAA
ACTCACGTAGC -> CTCACGTAGCG
ACTCACTTATT -> CTCACTTATTA
ACTCCAATGGG -> CTCCAATGGGT
ACTCCGGCTAG -> CTCCGGCTAGC
ACTCGAAGTTA -> CTCGAAGTTAA
ACTCGACTCGC -> CTCGACTCGCC
ACTCGCCGTAT -> CTCGCCGTATT
ACTCGGCATCC -> CTCGGCATCCT
ACTCGTGAGTG -> CTCGTGAGTGC
ACTCTTAGAGC -> CTCTTAGAGCC
ACTGACCGTCG -> CTGACCGTCGT
ACTGAGGCTTT -> CTGAGGCTTTT
ACTGATGGTCA -> CTGATGGTCAC
ACTGCCACATC -> CTGCCACATCA
ACTGCGCATAA -> CTGCGCATAAG
ACTGTCGGTTC -> CTGTCGGTTCG
ACTGTCTCGCG -> CTGTCTCGCGC
ACTTATTATAA -> CTTATTATAAA
ACTTCCATACC -> CTTCCATACCC
ACTTCCGCAGT -> CTTCCGCAGTT
ACTTCGCCAGC -> CTTCGCCAGCA
ACTTGAAGACG -> CTTGAAGACGG
ACTTGGCGCTA -> CTTGGCGCTAC
ACTTTGATTCA -> CTTTGATTCAT
ACTTTGTACCC -> CTTTGTACCCA
ACTTTTGCTTC -> CTTTTGCTTCG
AGAAACTTCCA -> GAAACTTCCAT
AGAAAGATTTC -> GAAAGATTTCA
AGAAAGGAGCG -> GAAAGGAGCGC
AGAAATTCCAG -> GAAATTCCAGT
AGAACAAAGGT -> GAACAAAGGTA
AGAACTTGGCG -> GAACTTGGCGC
AGAATAGGAAA -> GAATAGGAAAC
AGAATCTATGT -> GAATCTATGTG
AGACAACAGAA -> GACAACAGAAT
AGACACTTGAA -> GACACTTGAAG
AGACCAAACAC -> GACCAAACACT
AGACCAATCCT -> GACCAATCCTC
AGACCTGCATA -> GACCTGCATAC
AGACCTTCATA -> GACCTTCATAG
AGACGAGAACT -> GACGAGAACTT
AGACGGCTCCA -> GACGGCTCCAT
AGACTAAAAGG -> GACTAAAAGGT
AGACTAAACCT -> GACTAAACCTG
AGACTCACTTA -> GACTCACTTAT
AGACTCCAATG -> GACTCCAATGG
AGAGACTAAAC -> GAGACTAAACC
AGAGCCAGCAG -> GAGCCAGCAGG
AGAGCGCCAAT -> GAGCGCCAATC
AGAGTAGCACA -> GAGTAGCACAC
AGAGTTTAATT -> GAGTTTAATTA
AGATAAGACTC -> GATAAGACTCC
AGATAGCAGGG -> GATAGCAGGGC
AGATAGTGATT -> GATAGTGATTG
AGATATTGAAG -> GATATTGAAGT
AGATCTGGAAC -> GATCTGGAACC
AGATGAAGACC -> GATGAAGACCA
AGATGACTGAC -> GATGACTGACC
AGATGAGACAA -> GATGAGACAAC
AGATGAGGATC -> GATGAGGATCT
AGATGGCAAAT -> GATGGCAAATA
AGATGGGCAGT -> GATGGGCAGTG
AGATGGTATTG -> GATGGTATTGA
AGATGTTTGTC -> GATGTTTGTCC
AGATTCGAGGG -> GATTCGAGGGA
AGATTTCAACA -> GATTTCAACAT
AGCACACACGA -> GCACACACGAA
AGCACCCTCGG -> GCACCCTCGGA
AGCACGTTTCT -> GCACGTTTCTG
AGCAGGGCCGA -> GCAGGGCCGAA
AGCAGGGGTCC -> GCAGGGGTCCT
AGCCAGCAGGG -> GCCAGCAGGGG
AGCCATATCTA -> GCCATATCTAG
AGCCCTACCCC -> GCCCTACCCCC
AGCCGGTCGAA -> GCCGGTCGAAT
AGCCGTGCATT -> GCCGTGCATTG
AGCCTGGACAC -> GCCTGGACACC
AGCGAATACCA -> GCGAATACCAT
AGCGAATACTT -> GCGAATACTTT
AGCGAGTTACA -> GCGAGTTACAC
AGCGATCGTAA -> GCGATCGTAAA
AGCGCAAAATC -> GCGCAAAATCA
AGCGCAAGTAC -> GCGCAAGTACC
AGCGCAGTTCT -> GCGCAGTTCTA
AGCGCCAATCG -> GCGCCAATCGG
AGCGCTGCGTC -> GCGCTGCGTCC
AGCGGTATCAG -> GCGGTATCAGT
AGCGTACACAG -> GCGTACACAGC
AGCGTGCGACG -> GCGTGCGACGT
AGCGTTGGTGT -> GCGTTGGTGTA
AGCTAAACGCG -> GCTAAACGCGC
AGCTACTATCT -> GCTACTATCTT
AGCTCCGCAGA -> GCTCCGCAGAT
AGCTGAACGGC -> GCTGAACGGCT
AGCTGCTGCCC -> GCTGCTGCCCT
AGCTGCTGGTG -> GCTGCTGGTGT
AGCTTATCCCT -> GCTTATCCCTC
AGGAAACCCGT -> GGAAACCCGTA
AGGAAGAAATT -> GGAAGAAATTC
AGGAATGGCCG -> GGAATGGCCGC
AGGACCAGATG -> GGACCAGATGG
AGGACTCACGT -> GGACTCACGTA
AGGACTGCGCA -> GGACTGCGCAT
AGGAGCGCAGT -> GGAGCGCAGTT
AGGAGGGATCG -> GGAGGGATCGG
AGGATCTATGA -> GGATCTATGAT
AGGATTCGTGT -> GGATTCGTGTA
AGGCAACCAGA -> GGCAACCAGAA
AGGCACTGTCG -> GGCACTGTCGG
AGGCCAGGAAT -> GGCCAGGAATG
AGGCGATCAAT -> GGCGATCAATT
AGGCTAGGACC -> GGCTAGGACCA
AGGCTCGTCCA -> GGCTCGTCCAC
AGGCTTTTACA -> GGCTTTTACAC
AGGGAGAAAGA -> GGGAGAAAGAT
AGGGATCGGGG -> GGGATCGGGGG
AGGGCCGAAAT -> GGGCCGAAATG
AGGGCCGGGGA -> GGGCCGGGGAC
AGGGCGGCGGC -> GGGCGGCGGCG
AGGGGATCCAA -> GGGGATCCAAC
AGGGGGCCTGC -> GGGGGCCTGCC
AGGGGTCCTAG -> GGGGTCCTAGT
AGGGGTCTCCA -> GGGGTCTCCAC
AGGGTCTGGTA -> GGGTCTGGTAG
AGGTACATTAA -> GGTACATTAAT
AGGTACGATTC -> GGTACGATTCT
AGGTATGGCAA -> GGTATGGCAAG
AGGTCCAGCGG -> GGTCCAGCGGT
AGGTGGATACT -> GGTGGATACTA
AGGTGTCAGGA -> GGTGTCAGGAC
AGGTGTGATCG -> GGTGTGATCGA
AGTACAACATA -> GTACAACATAG
AGTACCATTGC -> GTACCATTGCT
AGTACTGTCTC -> GTACTGTCTCG
AGTAGCACACA -> GTAGCACACAC
AGTAGCACGTT -> GTAGCACGTTT
AGTAGGTGTCA -> GTAGGTGTCAG
AGTATGTGCGT -> GTATGTGCGTT
AGTCAAAAGAT -> GTCAAAAGATG
AGTCAGACTCA -> GTCAGACTCAC
AGTCCAAGTGC -> GTCCAAGTGCT
AGTCCTAGCTT -> GTCCTAGCTTA
AGTCCTTTAAA -> GTCCTTTAAAA
AGTCTCCATGT -> GTCTCCATGTG
AGTCTCGACGA -> GTCTCGACGAA
AGTGAGGGGGC -> GTGAGGGGGCC
AGTGATTGGTA -> GTGATTGGTAG
AGTGCCAGATG -> GTGCCAGATGG
AGTGCGTCAAT -> GTGCGTCAATT
AGTGCTCAGTC -> GTGCTCAGTCT
AGTGCTGTTAA -> GTGCTGTTAAA
AGTGGCCGATA -> GTGGCCGATAT
AGTGTGCGCGC -> GTGTGCGCGCC
AGTTAAACAAA -> GTTAAACAAAG
AGTTAAGATGA -> GTTAAGATGAC
AGTTAAGGAGG -> GTTAAGGAGGG
AGTTACACATA -> GTTACACATAC
AGTTACTCGTG -> GTTACTCGTGA
AGTTATACTTC -> GTTATACTTCC
AGTTCTACCGA -> GTTCTACCGAT
AGTTGTTATAG -> GTTGTTATAGT
AGTTTAATTAC -> GTTTAATTACT
AGTTTACTACG -> GTTTACTACGT
ATAAAAACGTA -> TAAAAACGTAA
ATAAAACCAGA -> TAAAACCAGAT
ATAAGACCTTC -> TAAGACCTTCA
ATAAGACTCCA -> TAAGACTCCAA
ATAAGATAGCA -> TAAGATAGCAG
ATAATTCACAC -> TAATTCACACG
ATACAAATTTT -> TACAAATTTTT
ATACCATTCCT -> TACCATTCCTA
ATACCCACTCC -> TACCCACTCCG
ATACCTGTACG -> TACCTGTACGG
ATACGAACCAT -> TACGAACCATC
ATACGAATTAA -> TACGAATTAAC
ATACTAAGGAA -> TACTAAGGAAG
ATACTATAGTT -> TACTATAGTTG
ATACTTCCGCA -> TACTTCCGCAG
ATACTTTGTAC -> TACTTTGTACC
ATAGAGTAGCA -> TAGAGTAGCAC
ATAGATAGTGA -> TAGATAGTGAT
ATAGCAGGGCC -> TAGCAGGGCCG
ATAGCCCTACC -> TAGCCCTACCC
ATAGCCTGGAC -> TAGCCTGGACA
ATAGCGAATAC -> TAGCGAATACT
ATAGGAAACCC -> TAGGAAACCCG
ATAGGATTCGT -> TAGGATTCGTG
ATAGGTACATT -> TAGGTACATTA
ATAGTCAGACT -> TAGTCAGACTC
ATAGTGATTGG -> TAGTGATTGGT
ATAGTTATACT -> TAGTTATACTT
ATAGTTGTTAT -> TAGTTGTTATA
ATATAGTCAGA -> TATAGTCAGAC
ATATATGGCAG -> TATATGGCAGG
ATATCTAGATC -> TATCTAGATCT
ATATGGCAGGA -> TATGGCAGGAC
ATATGGTATTA -> TATGGTATTAG
ATATTGAAGTC -> TATTGAAGTCC
ATCAATTGGTT -> TCAATTGGTTT
ATCACCACGTA -> TCACCACGTAG
ATCACCACTAG -> TCACCACTAGA
ATCAGAATAGG -> TCAGAATAGGA
ATCAGTACTGT -> TCAGTACTGTC
ATCAGTCTCGA -> TCAGTCTCGAC
ATCATCGAGAC -> TCATCGAGACC
ATCCAACTACC -> TCCAACTACCA
ATCCCTCTTGA -> TCCCTCTTGAA
ATCCGCCGACG -> TCCGCCGACGG
ATCCGGGATCT -> TCCGGGATCTA
ATCCGGGTAAC -> TCCGGGTAACA
ATCCTAGTAGG -> TCCTAGTAGGT
ATCCTCGTTCT -> TCCTCGTTCTA
ATCGACATAGG -> TCGACATAGGT
ATCGAGACCAA -> TCGAGACCAAT
ATCGGAAGCGA -> TCGGAAGCGAT
ATCGGCAAAGG -> TCGGCAAAGGG
ATCGGGGGCTG -> TCGGGGGCTGC
ATCGTAAAAGT -> TCGTAAAAGTT
ATCGTCCGGCC -> TCGTCCGGCCT
ATCTACCTTAT -> TCTACCTTATA
ATCTAGATCTG -> TCTAGATCTGG
ATCTATGATAG -> TCTATGATAGA
ATCTATGTGTA -> TCTATGTGTAC
ATCTGACTATT -> TCTGACTATTT
ATCTGAGGCAA -> TCTGAGGCAAC
ATCTGGAACCG -> TCTGGAACCGG
ATCTTATTACT -> TCTTATTACTC
ATCTTGAAATA -> TCTTGAAATAG
ATGAAGAAAGG -> TGAAGAAAGGA
ATGAAGACCAA -> TGAAGACCAAA
ATGACCAATGG -> TGACCAATGGG
ATGACTGACCG -> TGACTGACCGT
ATGAGACAACA -> TGAGACAACAG
ATGAGCTCCGC -> TGAGCTCCGCA
ATGAGGATCTA -> TGAGGATCTAT
ATGATACAAAT -> TGATACAAATT
ATGATAGATAG -> TGATAGATAGT
ATGCATGTCTA -> TGCATGTCTAA
ATGGCAAATAC -> TGGCAAATACG
ATGGCAAGCTA -> TGGCAAGCTAA
ATGGCAGGACT -> TGGCAGGACTG
ATGGCCGCTAG -> TGGCCGCTAGA
ATGGGACGATT -> TGGGACGATTC
ATGGGAGGCAC -> TGGGAGGCACT
ATGGGCAGTGT -> TGGGCAGTGTG
ATGGGTGGAGC -> TGGGTGGAGCG
ATGGTATTAGT -> TGGTATTAGTG
ATGGTATTGAT -> TGGTATTGATT
ATGGTCACTTT -> TGGTCACTTTT
ATGTAGCTGCT -> TGTAGCTGCTG
ATGTCTAACAT -> TGTCTAACATT
ATGTGCGTTTA -> TGTGCGTTTAA
ATGTGGGTTGA -> TGTGGGTTGAG
ATGTGTACCTC -> TGTGTACCTCG
ATGTTTGTCCA -> TGTTTGTCCAA
ATTAACTAGTA -> TTAACTAGTAC
ATTAAGTGGCC -> TTAAGTGGCCG
ATTAATCACCA -> TTAATCACCAC
ATTACATCCGG -> TTACATCCGGG
ATTACGGACAA -> TTACGGACAAA
ATTACTAGCGC -> TTACTAGCGCT
ATTACTCGAAG -> TTACTCGAAGT
ATTAGTGAGGG -> TTAGTGAGGGG
ATTATAAAACC -> TTATAAAACCA
ATTCAACGTAG -> TTCAACGTAGA
ATTCACACGAG -> TTCACACGAGG
ATTCATATAGT -> TTCATATAGTC
ATTCCAGTTAA -> TTCCAGTTAAG
ATTCCGCGGTG -> TTCCGCGGTGC
ATTCCTATCGG -> TTCCTATCGGA
ATTCGACTATC -> TTCGACTATCC
ATTCGAGAGCG -> TTCGAGAGCGC
ATTCGAGGGAG -> TTCGAGGGAGA
ATTCGTGTAAG -> TTCGTGTAAGC
ATTCTCCGGGC -> TTCTCCGGGCA
ATTCTCGGTTT -> TTCTCGGTTTC
ATTCTGATCTT -> TTCTGATCTTG
ATTGAAGTCCT -> TTGAAGTCCTT
ATTGATTGTCG -> TTGATTGTCGC
ATTGCTGCAAA -> TTGCTGCAAAT
ATTGCTGCACA -> TTGCTGCACAG
ATTGGACTATA -> TTGGACTATAA
ATTGGTAGCTG -> TTGGTAGCTGC
ATTGGTAGTGC -> TTGGTAGTGCC
ATTGGTTTGAA -> TTGGTTTGAAG
ATTGTCGCTCA -> TTGTCGCTCAT
ATTTAATCACC -> TTTAATCACCA
ATTTATTCGAG -> TTTATTCGAGA
ATTTCAACATC -> TTTCAACATCG
ATTTCAATTAA -> TTTCAATTAAG
ATTTTTCATAG -> TTTTTCATAGC
CAAAAGATGAA -> AAAAGATGAAG
CAAAATCATCG -> AAAATCATCGA
CAAACACTCGA -> AAACACTCGAC
CAAAGCGTGCG -> AAAGCGTGCGA
CAAAGGCCAGG -> AAAGGCCAGGA
CAAAGGGGTCT -> AAAGGGGTCTC
CAAAGGTATGG -> AAAGGTATGGC
CAAATACGAAC -> AAATACGAACC
CAAATACTATA -> AAATACTATAG
CAAATTTTTCA -> AAATTTTTCAT
CAACACACCAG -> AACACACCAGC
CAACAGAATCT -> AACAGAATCTA
CAACAGGCTAG -> AACAGGCTAGG
CAACATAGGAT -> AACATAGGATT
CAACATCGTCC -> AACATCGTCCG
CAACCAGAAAC -> AACCAGAAACT
CAACCCGGCAA -> AACCCGGCAAT
CAACGTAGACG -> AACGTAGACGA
CAACTACCAAG -> AACTACCAAGA
CAAGAGACTAA -> AAGAGACTAAA
CAAGCTAAACG -> AAGCTAAACGC
CAAGCTGAACG -> AAGCTGAACGG
CAAGGGCGGCG -> AAGGGCGGCGG
CAAGTACCATT -> AAGTACCATTG
CAAGTAGCACG -> AAGTAGCACGT
CAAGTGCTCAG -> AAGTGCTCAGT
CAATCCTCGTT -> AATCCTCGTTC
CAATCGGCAAA -> AATCGGCAAAG
CAATGAAGAAA -> AATGAAGAAAG
CAATGAGCTCC -> AATGAGCTCCG
CAATGGGAGGC -> AATGGGAGGCA
CAATGGGTGGA -> AATGGGTGGAG
CAATTAAGTGG -> AATTAAGTGGC
CAATTCTCGGT -> AATTCTCGGTT
CAATTCTGATC -> AATTCTGATCT
CAATTGGTTTG -> AATTGGTTTGA
CACAAGTAGCA -> ACAAGTAGCAC
CACACACGAAA -> ACACACGAAAC
CACACCAGCGC -> ACACCAGCGCA
CACACGAAACA -> ACACGAAACAC
CACACGAGGGG -> ACACGAGGGGA
CACACTCAAGC -> ACACTCAAGCT
CACAGATGTTT -> ACAGATGTTTG
CACAGCCATAT -> ACAGCCATATC
CACATACCTGT -> ACATACCTGTA
CACATATATGG -> ACATATATGGC
CACATCAGTCT -> ACATCAGTCTC
CACATTTCAAT -> ACATTTCAATT
CACCACGTAGA -> ACCACGTAGAA
CACCACTAGAT -> ACCACTAGATG
CACCAGAGTTT -> ACCAGAGTTTA
CACCAGCGCAA -> ACCAGCGCAAA
CACCCTCGGAC -> ACCCTCGGACC
CACCGGTTCCA -> ACCGGTTCCAC
CACCTAAGCTA -> ACCTAAGCTAC
CACCTGGCCGT -> ACCTGGCCGTC
CACGAAACACA -> ACGAAACACAA
CACGACTGATG -> ACGACTGATGG
CACGAGGGGAT -> ACGAGGGGATC
CACGGGTCGGG -> ACGGGTCGGGT
CACGTAGAACA -> ACGTAGAACAA
CACGTAGCGTA -> ACGTAGCGTAC
CACGTTTCTGA -> ACGTTTCTGAC
CACTAGATGAG -> ACTAGATGAGA
CACTCAAGCTG -> ACTCAAGCTGA
CACTCCGGCTA -> ACTCCGGCTAG
CACTCGACTCG -> ACTCGACTCGC
CACTGAGGCTT -> ACTGAGGCTTT
CACTGTCGGTT -> ACTGTCGGTTC
CACTTATTATA -> ACTTATTATAA
CACTTCGCCAG -> ACTTCGCCAGC
CACTTGAAGAC -> ACTTGAAGACG
CACTTTGATTC -> ACTTTGATTCA
CACTTTTGCTT -> ACTTTTGCTTC
CAGAAACTTCC -> AGAAACTTCCA
CAGAATAGGAA -> AGAATAGGAAA
CAGAATCTATG -> AGAATCTATGT
CAGACACTTGA -> AGACACTTGAA
CAGACTCACTT -> AGACTCACTTA
CAGAGTTTAAT -> AGAGTTTAATT
CAGATGAGGAT -> AGATGAGGATC
CAGATGGCAAA -> AGATGGCAAAT
CAGATGGGCAG -> AGATGGGCAGT
CAGATGGTATT -> AGATGGTATTG
CAGATGTTTGT -> AGATGTTTGTC
CAGATTCGAGG -> AGATTCGAGGG
CAGCACCCTCG -> AGCACCCTCGG
CAGCAGGGGTC -> AGCAGGGGTCC
CAGCCATATCT -> AGCCATATCTA
CAGCGAGTTAC -> AGCGAGTTACA
CAGCGCAAAAT -> AGCGCAAAATC
CAGCGGTATCA -> AGCGGTATCAG
CAGGAATGGCC -> AGGAATGGCCG
CAGGACTCACG -> AGGACTCACGT
CAGGACTGCGC -> AGGACTGCGCA
CAGGCTAGGAC -> AGGCTAGGACC
CAGGGCCGAAA -> AGGGCCGAAAT
CAGGGCCGGGG -> AGGGCCGGGGA
CAGGGGTCCTA -> AGGGGTCCTAG
CAGGGTCTGGT -> AGGGTCTGGTA
CAGGTGGATAC -> AGGTGGATACT
CAGTACTGTCT -> AGTACTGTCTC
CAGTCCAAGTG -> AGTCCAAGTGC
CAGTCCTAGCT -> AGTCCTAGCTT
CAGTCTCCATG -> AGTCTCCATGT
CAGTCTCGACG -> AGTCTCGACGA
CAGTGTGCGCG -> AGTGTGCGCGC
CAGTTAAGATG -> AGTTAAGATGA
CAGTTACTCGT -> AGTTACTCGTG
CAGTTCTACCG -> AGTTCTACCGA
CATAAGATAGC -> ATAAGATAGCA
CATACCCACTC -> ATACCCACTCC
CATACCTGTAC -> ATACCTGTACG
CATACGAATTA -> ATACGAATTAA
CATAGCCCTAC -> ATAGCCCTACC
CATAGCCTGGA -> ATAGCCTGGAC
CATAGCGAATA -> ATAGCGAATAC
CATAGGATTCG -> ATAGGATTCGT
CATAGGTACAT -> ATAGGTACATT
CATATAGTCAG -> ATATAGTCAGA
CATATATGGCA -> ATATATGGCAG
CATATCTAGAT -> ATATCTAGATC
CATCAGTCTCG -> ATCAGTCTCGA
CATCCGCCGAC -> ATCCGCCGACG
CATCCGGGATC -> ATCCGGGATCT
CATCCTAGTAG -> ATCCTAGTAGG
CATCGAGACCA -> ATCGAGACCAA
CATCGTCCGGC -> ATCGTCCGGCC
CATCTGAGGCA -> ATCTGAGGCAA
CATGATACAAA -> ATGATACAAAT
CATGTCTAACA -> ATGTCTAACAT
CATGTGGGTTG -> ATGTGGGTTGA
CATTAATCACC -> ATTAATCACCA
CATTACATCCG -> ATTACATCCGG
CATTCCTATCG -> ATTCCTATCGG
CATTGCTGCAC -> ATTGCTGCACA
CATTGGACTAT -> ATTGGACTATA
CATTGGTAGCT -> ATTGGTAGCTG
CATTTCAATTA -> ATTTCAATTAA
CCAAACACTCG -> CAAACACTCGA
CCAACACACCA -> CAACACACCAG
CCAACAGGCTA -> CAACAGGCTAG
CCAACCCGGCA -> CAACCCGGCAA
CCAACTACCAA -> CAACTACCAAG
CCAAGAGACTA -> CAAGAGACTAA
CCAAGTGCTCA -> CAAGTGCTCAG
CCAATCCTCGT -> CAATCCTCGTT
CCAATCGGCAA -> CAATCGGCAAA
CCAATGGGAGG -> CAATGGGAGGC
CCAATGGGTGG -> CAATGGGTGGA
CCACATCAGTC -> CACATCAGTCT
CCACATTTCAA -> CACATTTCAAT
CCACCAGAGTT -> CACCAGAGTTT
CCACGTAGAAC -> CACGTAGAACA
CCACTAGATGA -> CACTAGATGAG
CCACTCCGGCT -> CACTCCGGCTA
CCACTGAGGCT -> CACTGAGGCTT
CCACTTCGCCA -> CACTTCGCCAG
CCAGAAACTTC -> CAGAAACTTCC
CCAGAGTTTAA -> CAGAGTTTAAT
CCAGATGAGGA -> CAGATGAGGAT
CCAGATGGCAA -> CAGATGGCAAA
CCAGATGGGCA -> CAGATGGGCAG
CCAGCACCCTC -> CAGCACCCTCG
CCAGCAGGGGT -> CAGCAGGGGTC
CCAGCGCAAAA -> CAGCGCAAAAT
CCAGCGGTATC -> CAGCGGTATCA
CCAGGAATGGC -> CAGGAATGGCC
CCAGGGCCGGG -> CAGGGCCGGGG
CCAGGGTCTGG -> CAGGGTCTGGT
CCAGTTAAGAT -> CAGTTAAGATG
CCATACCCACT -> CATACCCACTC
CCATATCTAGA -> CATATCTAGAT
CCATCCGCCGA -> CATCCGCCGAC
CCATCTGAGGC -> CATCTGAGGCA
CCATGTGGGTT -> CATGTGGGTTG
CCATTCCTATC -> CATTCCTATCG
CCATTGCTGCA -> CATTGCTGCAC
CCCAACCCGGC -> CCAACCCGGCA
CCCACTCCGGC -> CCACTCCGGCT
CCCCCTGCGAT -> CCCCTGCGATC
CCCCTGCGATC -> CCCTGCGATCT
CCCGAGGCGAT -> CCGAGGCGATC
CCCGGCAATTC -> CCGGCAATTCT
CCCGTAACTGC -> CCGTAACTGCC
CCCTACCCCCT -> CCTACCCCCTG
CCCTCACGACT -> CCTCACGACTG
CCCTCAGTCCT -> CCTCAGTCCTA
CCCTCGGACCC -> CCTCGGACCCT
CCCTCTTGAAG -> CCTCTTGAAGC
CCCTGCGATCT -> CCTGCGATCTG
CCCTTATTCCG -> CCTTATTCCGC
CCCTTCAATGA -> CCTTCAATGAA
CCGAAATGACC -> CGAAATGACCA
CCGACGGTATT -> CGACGGTATTC
CCGAGGCGATC -> CGAGGCGATCA
CCGATATGGTA -> CGATATGGTAT
CCGATCAGAAT -> CGATCAGAATA
CCGCAGATTCG -> CGCAGATTCGA
CCGCAGTTACT -> CGCAGTTACTC
CCGCCGACGGT -> CGCCGACGGTA
CCGCGGTGCCG -> CGCGGTGCCGT
CCGCTAGACCT -> CGCTAGACCTG
CCGGCAATTCT -> CGGCAATTCTC
CCGGCCTCAGT -> CGGCCTCAGTC
CCGGCTAGCGC -> CGGCTAGCGCA
CCGGGATCTAC -> CGGGATCTACC
CCGGGCAGCGA -> CGGGCAGCGAG
CCGGGCTCTCC -> CGGGCTCTCCT
CCGGGGACTCG -> CGGGGACTCGG
CCGGGTAACAC -> CGGGTAACACT
CCGGTACTCTT -> CGGTACTCTTA
CCGGTCAATGA -> CGGTCAATGAG
CCGGTCGAATT -> CGGTCGAATTT
CCGGTTCCACA -> CGGTTCCACAT
CCGTAACTGCC -> CGTAACTGCCA
CCGTACGGCCC -> CGTACGGCCCG
CCGTATTCAAC -> CGTATTCAACG
CCGTCGTAGGT -> CGTCGTAGGTA
CCGTCTTCATA -> CGTCTTCATAG
CCGTGCATTGG -> CGTGCATTGGA
CCGTGCCGGTC -> CGTGCCGGTCA
CCTAAGCTACT -> CTAAGCTACTA
CCTACCCCCTG -> CTACCCCCTGC
CCTAGCTTATC -> CTAGCTTATCC
CCTAGTAGGTG -> CTAGTAGGTGT
CCTAGTGCGTC -> CTAGTGCGTCA
CCTATCGGAAG -> CTATCGGAAGC
CCTCACCGGTT -> CTCACCGGTTC
CCTCACGACTG -> CTCACGACTGA
CCTCAGTCCAA -> CTCAGTCCAAG
CCTCAGTCCTA -> CTCAGTCCTAG
CCTCGAGTTAA -> CTCGAGTTAAG
CCTCGGACCCT -> CTCGGACCCTC
CCTCGTTCTAC -> CTCGTTCTACA
CCTCTTGAAGC -> CTCTTGAAGCC
CCTGCAGGTGG -> CTGCAGGTGGA
CCTGCATACGA -> CTGCATACGAA
CCTGCCAGGGC -> CTGCCAGGGCC
CCTGCGATCTG -> CTGCGATCTGA
CCTGGACACCT -> CTGGACACCTA
CCTGGCCGTCT -> CTGGCCGTCTT
CCTGGGCGACA -> CTGGGCGACAA
CCTGTACGGTC -> CTGTACGGTCA
CCTTATAATTC -> CTTATAATTCA
CCTTATTCCGC -> CTTATTCCGCG
CCTTCAATGAA -> CTTCAATGAAG
CCTTCATAGCG -> CTTCATAGCGA
CCTTTAAAAGT -> CTTTAAAAGTC
CGAAACACAAG -> GAAACACAAGT
CGAAATGACCA -> GAAATGACCAA
CGAACCATCCG -> GAACCATCCGC
CGAAGTTAAAC -> GAAGTTAAACA
CGAATACCATT -> GAATACCATTC
CGAATACTTTG -> GAATACTTTGT
CGAATGTAGCT -> GAATGTAGCTG
CGAATTAACTA -> GAATTAACTAG
CGAATTTAATC -> GAATTTAATCA
CGACAAGGGCG -> GACAAGGGCGG
CGACATAGGTA -> GACATAGGTAC
CGACGAATGTA -> GACGAATGTAG
CGACGGTATTC -> GACGGTATTCG
CGACGTACCAA -> GACGTACCAAC
CGACTATCCGG -> GACTATCCGGG
CGACTCGCCGT -> GACTCGCCGTA
CGACTGATGGT -> GACTGATGGTC
CGAGAACTTGG -> GAGAACTTGGC
CGAGACCAATC -> GAGACCAATCC
CGAGAGCGCCA -> GAGAGCGCCAA
CGAGGCGATCA -> GAGGCGATCAA
CGAGGGAGAAA -> GAGGGAGAAAG
CGAGGGGATCC -> GAGGGGATCCA
CGAGTTAAGGA -> GAGTTAAGGAG
CGAGTTACACA -> GAGTTACACAT
CGATATGGTAT -> GATATGGTATT
CGATCAATTGG -> GATCAATTGGT
CGATCAGAATA -> GATCAGAATAG
CGATCGTAAAA -> GATCGTAAAAG
CGATCTGACTA -> GATCTGACTAT
CGATTCTCCGG -> GATTCTCCGGG
CGATTCTTCCA -> GATTCTTCCAA
CGCAAAATCAT -> GCAAAATCATC
CGCAAGTACCA -> GCAAGTACCAT
CGCAGATTCGA -> GCAGATTCGAG
CGCAGTTACTC -> GCAGTTACTCG
CGCAGTTCTAC -> GCAGTTCTACC
CGCATAAGATA -> GCATAAGATAG
CGCCAATCGGC -> GCCAATCGGCA
CGCCAGCACCC -> GCCAGCACCCT
CGCCAGGGTCT -> GCCAGGGTCTG
CGCCGACGGTA -> GCCGACGGTAT
CGCCGTACGGC -> GCCGTACGGCC
CGCCGTATTCA -> GCCGTATTCAA
CGCGCCAGGGT -> GCGCCAGGGTC
CGCGCCGTACG -> GCGCCGTACGG
CGCGCTTTTAG -> GCGCTTTTAGC
CGCGGTGCCGT -> GCGGTGCCGTG
CGCTACACGGG -> GCTACACGGGT
CGCTAGACCTG -> GCTAGACCTGC
CGCTCATGATA -> GCTCATGATAC
CGCTGCGTCCT -> GCTGCGTCCTG
CGCTTTTAGCC -> GCTTTTAGCCG
CGGAAGCGATC -> GGAAGCGATCG
CGGACAAAGGC -> GGACAAAGGCC
CGGACCCTCAG -> GGACCCTCAGT
CGGCAAAGGGG -> GGCAAAGGGGT
CGGCAATTCTC -> GGCAATTCTCG
CGGCATCCTAG -> GGCATCCTAGT
CGGCCCGAGGC -> GGCCCGAGGCG
CGGCCTCAGTC -> GGCCTCAGTCC
CGGCGGCGGTC -> GGCGGCGGTCG
CGGCGGTCGTG -> GGCGGTCGTGA
CGGCTAGCGCA -> GGCTAGCGCAA
CGGCTCATTGG -> GGCTCATTGGT
CGGCTCCATCT -> GGCTCCATCTG
CGGGATCTACC -> GGGATCTACCT
CGGGCAGCGAG -> GGGCAGCGAGT
CGGGCTCTCCT -> GGGCTCTCCTC
CGGGGACTCGG -> GGGGACTCGGC
CGGGGGCTGCG -> GGGGGCTGCGG
CGGGTAACACT -> GGGTAACACTT
CGGGTCGGGTT -> GGGTCGGGTTA
CGGGTTATGGG -> GGGTTATGGGA
CGGTACTCTTA -> GGTACTCTTAG
CGGTATCAGTA -> GGTATCAGTAC
CGGTATTCGAC -> GGTATTCGACT
CGGTCAATGAG -> GGTCAATGAGC
CGGTCACATAT -> GGTCACATATA
CGGTCACCTGG -> GGTCACCTGGC
CGGTCGAATTT -> GGTCGAATTTA
CGGTCGTGATT -> GGTCGTGATTG
CGGTGCCGTGC -> GGTGCCGTGCC
CGGTTCCACAT -> GGTTCCACATT
CGGTTCGTAGG -> GGTTCGTAGGT
CGGTTTCCACC -> GGTTTCCACCA
CGTAAAAGTTT -> GTAAAAGTTTA
CGTAACCGGGC -> GTAACCGGGCT
CGTAACTGCCA -> GTAACTGCCAC
CGTACACAGCC -> GTACACAGCCA
CGTACCAACAG -> GTACCAACAGG
CGTACGGCCCG -> GTACGGCCCGA
CGTAGAACAAA -> GTAGAACAAAG
CGTAGACGAGA -> GTAGACGAGAA
CGTAGCGTACA -> GTAGCGTACAC
CGTAGGTACGA -> GTAGGTACGAT
CGTAGGTCCAG -> GTAGGTCCAGC
CGTATTCAACG -> GTATTCAACGT
CGTCAATTCTG -> GTCAATTCTGA
CGTCCACTTCG -> GTCCACTTCGC
CGTCCGGCCTC -> GTCCGGCCTCA
CGTCCTGGGCG -> GTCCTGGGCGA
CGTCGTAGGTA -> GTCGTAGGTAC
CGTCTTCATAG -> GTCTTCATAGC
CGTGAGTGCTG -> GTGAGTGCTGT
CGTGATTGCTG -> GTGATTGCTGC
CGTGCATTGGA -> GTGCATTGGAC
CGTGCCGGTCA -> GTGCCGGTCAA
CGTGCGACGTA -> GTGCGACGTAC
CGTGTAAGCGA -> GTGTAAGCGAA
CGTGTAGACTA -> GTGTAGACTAA
CGTTAATGCAT -> GTTAATGCATG
CGTTATAAAAA -> GTTATAAAAAC
CGTTCTACAGA -> GTTCTACAGAT
CGTTGGTGTAC -> GTTGGTGTACG
CGTTTAATTAC -> GTTTAATTACG
CGTTTCTGACC -> GTTTCTGACCC
CTAAAAGGTGT -> TAAAAGGTGTG
CTAAACCTGCA -> TAAACCTGCAG
CTAAACGCGCC -> TAAACGCGCCG
CTAACATTACA -> TAACATTACAT
CTAAGCTACTA -> TAAGCTACTAT
CTAAGGAAGAA -> TAAGGAAGAAA
CTACACGGGTC -> TACACGGGTCG
CTACAGATGGT -> TACAGATGGTA
CTACCAAGAGA -> TACCAAGAGAC
CTACCCCCTGC -> TACCCCCTGCG
CTACCGATCAG -> TACCGATCAGA
CTACCTTATAA -> TACCTTATAAT
CTACGTGTAGA -> TACGTGTAGAC
CTACTATCTTA -> TACTATCTTAT
CTAGACCTGCA -> TAGACCTGCAT
CTAGATCTGGA -> TAGATCTGGAA
CTAGATGAGAC -> TAGATGAGACA
CTAGCGCAAGT -> TAGCGCAAGTA
CTAGCGCTGCG -> TAGCGCTGCGT
CTAGCTTATCC -> TAGCTTATCCC
CTAGGACCAGA -> TAGGACCAGAT
CTAGTACAACA -> TAGTACAACAT
CTAGTAGGTGT -> TAGTAGGTGTC
CTAGTGCGTCA -> TAGTGCGTCAA
CTATAAGACCT -> TATAAGACCTT
CTATAGTTGTT -> TATAGTTGTTA
CTATCCGGGTA -> TATCCGGGTAA
CTATCGGAAGC -> TATCGGAAGCG
CTATCTTATTA -> TATCTTATTAC
CTATGATAGAT -> TATGATAGATA
CTATGTGTACC -> TATGTGTACCT
CTATTTATTCG -> TATTTATTCGA
CTCAAGCTGAA -> TCAAGCTGAAC
CTCACCGGTTC -> TCACCGGTTCC
CTCACGACTGA -> TCACGACTGAT
CTCACGTAGCG -> TCACGTAGCGT
CTCACTTATTA -> TCACTTATTAT
CTCAGTCCAAG -> TCAGTCCAAGT
CTCAGTCCTAG -> TCAGTCCTAGC
CTCAGTCTCCA -> TCAGTCTCCAT
CTCATGATACA -> TCATGATACAA
CTCATTGGTAG -> TCATTGGTAGC
CTCCAATGGGT -> TCCAATGGGTG
CTCCACTGAGG -> TCCACTGAGGC
CTCCATCTGAG -> TCCATCTGAGG
CTCCATGTGGG -> TCCATGTGGGT
CTCCGCAGATT -> TCCGCAGATTC
CTCCGGCTAGC -> TCCGGCTAGCG
CTCCGGGCAGC -> TCCGGGCAGCG
CTCCTCACCGG -> TCCTCACCGGT
CTCGAAGTTAA -> TCGAAGTTAAA
CTCGACGAATG -> TCGACGAATGT
CTCGACTCGCC -> TCGACTCGCCG
CTCGAGTTAAG -> TCGAGTTAAGG
CTCGCCGTATT -> TCGCCGTATTC
CTCGCGCTTTT -> TCGCGCTTTTA
CTCGGACCCTC -> TCGGACCCTCA
CTCGGCATCCT -> TCGGCATCCTA
CTCGGTTTCCA -> TCGGTTTCCAC
CTCGTCCACTT -> TCGTCCACTTC
CTCGTGAGTGC -> TCGTGAGTGCT
CTCGTTCTACA -> TCGTTCTACAG
CTCTCCTCACC -> TCTCCTCACCG
CTCTTAGAGCC -> TCTTAGAGCCA
CTCTTGAAGCC -> TCTTGAAGCCG
CTGAACGGCTC -> TGAACGGCTCA
CTGACCCTCAC -> TGACCCTCACG
CTGACCGTCGT -> TGACCGTCGTA
CTGACTATTTA -> TGACTATTTAT
CTGAGGCAACC -> TGAGGCAACCA
CTGAGGCTTTT -> TGAGGCTTTTA
CTGATCTTGAA -> TGATCTTGAAA
CTGATGGTCAC -> TGATGGTCACT
CTGCAAATACT -> TGCAAATACTA
CTGCACAGATG -> TGCACAGATGT
CTGCAGGTGGA -> TGCAGGTGGAT
CTGCATACGAA -> TGCATACGAAT
CTGCCACATCA -> TGCCACATCAG
CTGCCAGGGCC -> TGCCAGGGCCG
CTGCCCTTATT -> TGCCCTTATTC
CTGCGATCTGA -> TGCGATCTGAC
CTGCGCATAAG -> TGCGCATAAGA
CTGCGGTCACC -> TGCGGTCACCT
CTGCGTCCTGG -> TGCGTCCTGGG
CTGCTGCCCTT -> TGCTGCCCTTA
CTGCTGGTGTG -> TGCTGGTGTGG
CTGGAACCGGT -> TGGAACCGGTA
CTGGACACCTA -> TGGACACCTAA
CTGGCCGTCTT -> TGGCCGTCTTC
CTGGGCGACAA -> TGGGCGACAAG
CTGGTAGATAA -> TGGTAGATAAG
CTGGTGTGGGT -> TGGTGTGGGTT
CTGTACGGTCA -> TGTACGGTCAC
CTGTCGGTTCG -> TGTCGGTTCGT
CTGTCTCGCGC -> TGTCTCGCGCT
CTGTTAAACAG -> TGTTAAACAGA
CTTAGAGCCAG -> TTAGAGCCAGC
CTTATAATTCA -> TTATAATTCAC
CTTATCCCTCT -> TTATCCCTCTT
CTTATTACTCG -> TTATTACTCGA
CTTATTATAAA -> TTATTATAAAA
CTTATTCCGCG -> TTATTCCGCGG
CTTCAATGAAG -> TTCAATGAAGA
CTTCATAGCCC -> TTCATAGCCCT
CTTCATAGCGA -> TTCATAGCGAA
CTTCCATACCC -> TTCCATACCCA
CTTCCGCAGTT -> TTCCGCAGTTA
CTTCGCCAGCA -> TTCGCCAGCAC
CTTCGTTAATG -> TTCGTTAATGC
CTTGAAATAGA -> TTGAAATAGAG
CTTGAAGACGG -> TTGAAGACGGC
CTTGAAGCCGT -> TTGAAGCCGTG
CTTGGCGCTAC -> TTGGCGCTACA
CTTTAAAAGTC -> TTTAAAAGTCA
CTTTGATTCAT -> TTTGATTCATA
CTTTGTACCCA -> TTTGTACCCAA
CTTTTACACAC -> TTTTACACACT
CTTTTAGCCGG -> TTTTAGCCGGT
CTTTTGCTTCG -> TTTTGCTTCGT
GAAACACAAGT -> AAACACAAGTA
GAAACCCGTAA -> AAACCCGTAAC
GAAACTTCCAT -> AAACTTCCATA
GAAAGATTTCA -> AAAGATTTCAA
GAAAGGAGCGC -> AAAGGAGCGCA
GAAATAGAGTA -> AAATAGAGTAG
GAAATGACCAA -> AAATGACCAAT
GAAATTCCAGT -> AAATTCCAGTT
GAACAAAGGTA -> AACAAAGGTAT
GAACCATCCGC -> AACCATCCGCC
GAACCGGTACT -> AACCGGTACTC
GAACGGCTCAT -> AACGGCTCATT
GAACTTGGCGC -> AACTTGGCGCT
GAAGAAAGGAG -> AAGAAAGGAGC
GAAGAAATTCC -> AAGAAATTCCA
GAAGACCAAAC -> AAGACCAAACA
GAAGACGGCTC -> AAGACGGCTCC
GAAGCCGTGCA -> AAGCCGTGCAT
GAAGCGATCGT -> AAGCGATCGTA
GAAGTATGTGC -> AAGTATGTGCG
GAAGTCCTTTA -> AAGTCCTTTAA
GAAGTTAAACA -> AAGTTAAACAA
GAATACCATTC -> AATACCATTCC
GAATACTTTGT -> AATACTTTGTA
GAATAGGAAAC -> AATAGGAAACC
GAATCTATGTG -> AATCTATGTGT
GAATGGCCGCT -> AATGGCCGCTA
GAATGTAGCTG -> AATGTAGCTGC
GAATTAACTAG -> AATTAACTAGT
GAATTTAATCA -> AATTTAATCAC
GACAAAGGCCA -> ACAAAGGCCAG
GACAACAGAAT -> ACAACAGAATC
GACAAGGGCGG -> ACAAGGGCGGC
GACACCTAAGC -> ACACCTAAGCT
GACACTTGAAG -> ACACTTGAAGA
GACATAGGTAC -> ACATAGGTACA
GACCAAACACT -> ACCAAACACTC
GACCAATCCTC -> ACCAATCCTCG
GACCAATGGGA -> ACCAATGGGAG
GACCAGATGGC -> ACCAGATGGCA
GACCCTCACGA -> ACCCTCACGAC
GACCCTCAGTC -> ACCCTCAGTCC
GACCGTCGTAG -> ACCGTCGTAGG
GACCTGCATAC -> ACCTGCATACG
GACCTTCATAG -> ACCTTCATAGC
GACGAATGTAG -> ACGAATGTAGC
GACGAGAACTT -> ACGAGAACTTG
GACGATTCTTC -> ACGATTCTTCC
GACGGCTCCAT -> ACGGCTCCATC
GACGGTATTCG -> ACGGTATTCGA
GACGTACCAAC -> ACGTACCAACA
GACTAAAAGGT -> ACTAAAAGGTG
GACTAAACCTG -> ACTAAACCTGC
GACTATAAGAC -> ACTATAAGACC
GACTATCCGGG -> ACTATCCGGGT
GACTATTTATT -> ACTATTTATTC
GACTCACGTAG -> ACTCACGTAGC
GACTCACTTAT -> ACTCACTTATT
GACTCCAATGG -> ACTCCAATGGG
GACTCGCCGTA -> ACTCGCCGTAT
GACTCGGCATC -> ACTCGGCATCC
GACTGACCGTC -> ACTGACCGTCG
GACTGATGGTC -> ACTGATGGTCA
GACTGCGCATA -> ACTGCGCATAA
GAGAAAGATTT -> AGAAAGATTTC
GAGAACTTGGC -> AGAACTTGGCG
GAGACAACAGA -> AGACAACAGAA
GAGACCAATCC -> AGACCAATCCT
GAGACTAAACC -> AGACTAAACCT
GAGAGCGCCAA -> AGAGCGCCAAT
GAGATATTGAA -> AGATATTGAAG
GAGCCAGCAGG -> AGCCAGCAGGG
GAGCGCAGTTC -> AGCGCAGTTCT
GAGCGCCAATC -> AGCGCCAATCG
GAGCGTTGGTG -> AGCGTTGGTGT
GAGCTCCGCAG -> AGCTCCGCAGA
GAGGATCTATG -> AGGATCTATGA
GAGGCAACCAG -> AGGCAACCAGA
GAGGCACTGTC -> AGGCACTGTCG
GAGGCGATCAA -> AGGCGATCAAT
GAGGCTTTTAC -> AGGCTTTTACA
GAGGGAGAAAG -> AGGGAGAAAGA
GAGGGATCGGG -> AGGGATCGGGG
GAGGGGATCCA -> AGGGGATCCAA
GAGGGGGCCTG -> AGGGGGCCTGC
GAGTAGCACAC -> AGTAGCACACA
GAGTGCTGTTA -> AGTGCTGTTAA
GAGTTAAGGAG -> AGTTAAGGAGG
GAGTTACACAT -> AGTTACACATA
GAGTTTAATTA -> AGTTTAATTAC
GATAAGACTCC -> ATAAGACTCCA
GATACAAATTT -> ATACAAATTTT
GATACTAAGGA -> ATACTAAGGAA
GATAGATAGTG -> ATAGATAGTGA
GATAGCAGGGC -> ATAGCAGGGCC
GATAGTGATTG -> ATAGTGATTGG
GATATGGTATT -> ATATGGTATTA
GATATTGAAGT -> ATATTGAAGTC
GATCAATTGGT -> ATCAATTGGTT
GATCAGAATAG -> ATCAGAATAGG
GATCCAACTAC -> ATCCAACTACC
GATCGACATAG -> ATCGACATAGG
GATCGGGGGCT -> ATCGGGGGCTG
GATCGTAAAAG -> ATCGTAAAAGT
GATCTACCTTA -> ATCTACCTTAT
GATCTATGATA -> ATCTATGATAG
GATCTGACTAT -> ATCTGACTATT
GATCTGGAACC -> ATCTGGAACCG
GATCTTGAAAT -> ATCTTGAAATA
GATGAAGACCA -> ATGAAGACCAA
GATGACTGACC -> ATGACTGACCG
GATGAGACAAC -> ATGAGACAACA
GATGAGGATCT -> ATGAGGATCTA
GATGGCAAATA -> ATGGCAAATAC
GATGGGCAGTG -> ATGGGCAGTGT
GATGGTATTGA -> ATGGTATTGAT
GATGGTCACTT -> ATGGTCACTTT
GATGTTTGTCC -> ATGTTTGTCCA
GATTCATATAG -> ATTCATATAGT
GATTCGAGGGA -> ATTCGAGGGAG
GATTCGTGTAA -> ATTCGTGTAAG
GATTCTCCGGG -> ATTCTCCGGGC
GATTCTTCCAA -> ATTCTTCCAAC
GATTGCTGCAA -> ATTGCTGCAAA
GATTGGTAGTG -> ATTGGTAGTGC
GATTGTCGCTC -> ATTGTCGCTCA
GATTTCAACAT -> ATTTCAACATC
GCAAAATCATC -> CAAAATCATCG
GCAAAGGGGTC -> CAAAGGGGTCT
GCAAATACGAA -> CAAATACGAAC
GCAAATACTAT -> CAAATACTATA
GCAACCAGAAA -> CAACCAGAAAC
GCAAGCTAAAC -> CAAGCTAAACG
GCAAGTACCAT -> CAAGTACCATT
GCAATTCTCGG -> CAATTCTCGGT
GCACACACGAA -> CACACACGAAA
GCACAGATGTT -> CACAGATGTTT
GCACCCTCGGA -> CACCCTCGGAC
GCACGTTTCTG -> CACGTTTCTGA
GCACTGTCGGT -> CACTGTCGGTT
GCAGATTCGAG -> CAGATTCGAGG
GCAGCGAGTTA -> CAGCGAGTTAC
GCAGGACTGCG -> CAGGACTGCGC
GCAGGGCCGAA -> CAGGGCCGAAA
GCAGGGGTCCT -> CAGGGGTCCTA
GCAGGTGGATA -> CAGGTGGATAC
GCAGTGTGCGC -> CAGTGTGCGCG
GCAGTTACTCG -> CAGTTACTCGT
GCAGTTCTACC -> CAGTTCTACCG
GCATAAGATAG -> CATAAGATAGC
GCATACGAATT -> CATACGAATTA
GCATCCTAGTA -> CATCCTAGTAG
GCATGTCTAAC -> CATGTCTAACA
GCATTGGACTA -> CATTGGACTAT
GCCAATCGGCA -> CCAATCGGCAA
GCCACATCAGT -> CCACATCAGTC
GCCAGATGGGC -> CCAGATGGGCA
GCCAGCACCCT -> CCAGCACCCTC
GCCAGCAGGGG -> CCAGCAGGGGT
GCCAGGAATGG -> CCAGGAATGGC
GCCAGGGCCGG -> CCAGGGCCGGG
GCCAGGGTCTG -> CCAGGGTCTGG
GCCATATCTAG -> CCATATCTAGA
GCCCGAGGCGA -> CCCGAGGCGAT
GCCCTACCCCC -> CCCTACCCCCT
GCCCTTATTCC -> CCCTTATTCCG
GCCGAAATGAC -> CCGAAATGACC
GCCGACGGTAT -> CCGACGGTATT
GCCGATATGGT -> CCGATATGGTA
GCCGCTAGACC -> CCGCTAGACCT
GCCGGGGACTC -> CCGGGGACTCG
GCCGGTCAATG -> CCGGTCAATGA
GCCGGTCGAAT -> CCGGTCGAATT
GCCGTACGGCC -> CCGTACGGCCC
GCCGTATTCAA -> CCGTATTCAAC
GCCGTCTTCAT -> CCGTCTTCATA
GCCGTGCATTG -> CCGTGCATTGG
GCCGTGCCGGT -> CCGTGCCGGTC
GCCTCAGTCCA -> CCTCAGTCCAA
GCCTGCCAGGG -> CCTGCCAGGGC
GCCTGGACACC -> CCTGGACACCT
GCGAATACCAT -> CGAATACCATT
GCGAATACTTT -> CGAATACTTTG
GCGACAAGGGC -> CGACAAGGGCG
GCGACGTACCA -> CGACGTACCAA
GCGAGTTACAC -> CGAGTTACACA
GCGATCAATTG -> CGATCAATTGG
GCGATCGTAAA -> CGATCGTAAAA
GCGATCTGACT -> CGATCTGACTA
GCGCAAAATCA -> CGCAAAATCAT
GCGCAAGTACC -> CGCAAGTACCA
GCGCAGTTCTA -> CGCAGTTCTAC
GCGCATAAGAT -> CGCATAAGATA
GCGCCAATCGG -> CGCCAATCGGC
GCGCCAGGGTC -> CGCCAGGGTCT
GCGCCGTACGG -> CGCCGTACGGC
GCGCGCCAGGG -> CGCGCCAGGGT
GCGCTACACGG -> CGCTACACGGG
GCGCTGCGTCC -> CGCTGCGTCCT
GCGCTTTTAGC -> CGCTTTTAGCC
GCGGCGGCGGT -> CGGCGGCGGTC
GCGGCGGTCGT -> CGGCGGTCGTG
GCGGTATCAGT -> CGGTATCAGTA
GCGGTCACCTG -> CGGTCACCTGG
GCGGTCGTGAT -> CGGTCGTGATT
GCGGTGCCGTG -> CGGTGCCGTGC
GCGTACACAGC -> CGTACACAGCC
GCGTCAATTCT -> CGTCAATTCTG
GCGTCCTGGGC -> CGTCCTGGGCG
GCGTGCGACGT -> CGTGCGACGTA
GCGTTGGTGTA -> CGTTGGTGTAC
GCGTTTAATTA -> CGTTTAATTAC
GCTAAACGCGC -> CTAAACGCGCC
GCTACACGGGT -> CTACACGGGTC
GCTACTATCTT -> CTACTATCTTA
GCTAGACCTGC -> CTAGACCTGCA
GCTAGCGCAAG -> CTAGCGCAAGT
GCTAGGACCAG -> CTAGGACCAGA
GCTCAGTCTCC -> CTCAGTCTCCA
GCTCATGATAC -> CTCATGATACA
GCTCATTGGTA -> CTCATTGGTAG
GCTCCATCTGA -> CTCCATCTGAG
GCTCCGCAGAT -> CTCCGCAGATT
GCTCGTCCACT -> CTCGTCCACTT
GCTCTCCTCAC -> CTCTCCTCACC
GCTGAACGGCT -> CTGAACGGCTC
GCTGCAAATAC -> CTGCAAATACT
GCTGCACAGAT -> CTGCACAGATG
GCTGCCCTTAT -> CTGCCCTTATT
GCTGCGGTCAC -> CTGCGGTCACC
GCTGCGTCCTG -> CTGCGTCCTGG
GCTGCTGCCCT -> CTGCTGCCCTT
GCTGCTGGTGT -> CTGCTGGTGTG
GCTGGTGTGGG -> CTGGTGTGGGT
GCTGTTAAACA -> CTGTTAAACAG
GCTTATCCCTC -> CTTATCCCTCT
GCTTCGTTAAT -> CTTCGTTAATG
GCTTTTACACA -> CTTTTACACAC
GCTTTTAGCCG -> CTTTTAGCCGG
GGAAACCCGTA -> GAAACCCGTAA
GGAACCGGTAC -> GAACCGGTACT
GGAAGAAATTC -> GAAGAAATTCC
GGAAGCGATCG -> GAAGCGATCGT
GGAATGGCCGC -> GAATGGCCGCT
GGACAAAGGCC -> GACAAAGGCCA
GGACACCTAAG -> GACACCTAAGC
GGACCAGATGG -> GACCAGATGGC
GGACCCTCAGT -> GACCCTCAGTC
GGACGATTCTT -> GACGATTCTTC
GGACTATAAGA -> GACTATAAGAC
GGACTCACGTA -> GACTCACGTAG
GGACTCGGCAT -> GACTCGGCATC
GGACTGCGCAT -> GACTGCGCATA
GGAGAAAGATT -> GAGAAAGATTT
GGAGCGCAGTT -> GAGCGCAGTTC
GGAGCGTTGGT -> GAGCGTTGGTG
GGAGGCACTGT -> GAGGCACTGTC
GGAGGGATCGG -> GAGGGATCGGG
GGATACTAAGG -> GATACTAAGGA
GGATCCAACTA -> GATCCAACTAC
GGATCGGGGGC -> GATCGGGGGCT
GGATCTACCTT -> GATCTACCTTA
GGATCTATGAT -> GATCTATGATA
GGATTCGTGTA -> GATTCGTGTAA
GGCAAAGGGGT -> GCAAAGGGGTC
GGCAAATACGA -> GCAAATACGAA
GGCAACCAGAA -> GCAACCAGAAA
GGCAAGCTAAA -> GCAAGCTAAAC
GGCAATTCTCG -> GCAATTCTCGG
GGCACTGTCGG -> GCACTGTCGGT
GGCAGCGAGTT -> GCAGCGAGTTA
GGCAGGACTGC -> GCAGGACTGCG
GGCAGTGTGCG -> GCAGTGTGCGC
GGCATCCTAGT -> GCATCCTAGTA
GGCCAGGAATG -> GCCAGGAATGG
GGCCCGAGGCG -> GCCCGAGGCGA
GGCCGAAATGA -> GCCGAAATGAC
GGCCGATATGG -> GCCGATATGGT
GGCCGCTAGAC -> GCCGCTAGACC
GGCCGGGGACT -> GCCGGGGACTC
GGCCGTCTTCA -> GCCGTCTTCAT
GGCCTCAGTCC -> GCCTCAGTCCA
GGCCTGCCAGG -> GCCTGCCAGGG
GGCGACAAGGG -> GCGACAAGGGC
GGCGATCAATT -> GCGATCAATTG
GGCGCTACACG -> GCGCTACACGG
GGCGGCGGCGG -> GCGGCGGCGGT
GGCGGCGGTCG -> GCGGCGGTCGT
GGCGGTCGTGA -> GCGGTCGTGAT
GGCTAGCGCAA -> GCTAGCGCAAG
GGCTAGGACCA -> GCTAGGACCAG
GGCTCATTGGT -> GCTCATTGGTA
GGCTCCATCTG -> GCTCCATCTGA
GGCTCGTCCAC -> GCTCGTCCACT
GGCTCTCCTCA -> GCTCTCCTCAC
GGCTGCGGTCA -> GCTGCGGTCAC
GGCTTTTACAC -> GCTTTTACACA
GGGACGATTCT -> GGACGATTCTT
GGGACTCGGCA -> GGACTCGGCAT
GGGAGAAAGAT -> GGAGAAAGATT
GGGAGGCACTG -> GGAGGCACTGT
GGGATCCAACT -> GGATCCAACTA
GGGATCGGGGG -> GGATCGGGGGC
GGGATCTACCT -> GGATCTACCTT
GGGCAGCGAGT -> GGCAGCGAGTT
GGGCAGTGTGC -> GGCAGTGTGCG
GGGCCGAAATG -> GGCCGAAATGA
GGGCCGGGGAC -> GGCCGGGGACT
GGGCCTGCCAG -> GGCCTGCCAGG
GGGCGACAAGG -> GGCGACAAGGG
GGGCGGCGGCG -> GGCGGCGGCGG
GGGCTCTCCTC -> GGCTCTCCTCA
GGGCTGCGGTC -> GGCTGCGGTCA
GGGGACTCGGC -> GGGACTCGGCA
GGGGATCCAAC -> GGGATCCAACT
GGGGCCTGCCA -> GGGCCTGCCAG
GGGGCTGCGGT -> GGGCTGCGGTC
GGGGGCCTGCC -> GGGGCCTGCCA
GGGGGCTGCGG -> GGGGCTGCGGT
GGGGTCCTAGT -> GGGTCCTAGTG
GGGGTCTCCAC -> GGGTCTCCACT
GGGTAACACTT -> GGTAACACTTT
GGGTCCTAGTG -> GGTCCTAGTGC
GGGTCGGGTTA -> GGTCGGGTTAT
GGGTCTCCACT -> GGTCTCCACTG
GGGTCTGGTAG -> GGTCTGGTAGA
GGGTGGAGCGT -> GGTGGAGCGTT
GGGTTACCCTT -> GGTTACCCTTC
GGGTTATGGGA -> GGTTATGGGAC
GGGTTGAGATA -> GGTTGAGATAT
GGTAACACTTT -> GTAACACTTTG
GGTACATTAAT -> GTACATTAATC
GGTACGATTCT -> GTACGATTCTC
GGTACTCTTAG -> GTACTCTTAGA
GGTAGATAAGA -> GTAGATAAGAC
GGTAGCTGCTG -> GTAGCTGCTGG
GGTAGTGCCAG -> GTAGTGCCAGA
GGTATCAGTAC -> GTATCAGTACT
GGTATGGCAAG -> GTATGGCAAGC
GGTATTAGTGA -> GTATTAGTGAG
GGTATTCGACT -> GTATTCGACTA
GGTATTGATTG -> GTATTGATTGT
GGTCAATGAGC -> GTCAATGAGCT
GGTCACATATA -> GTCACATATAT
GGTCACCTGGC -> GTCACCTGGCC
GGTCACTTTTG -> GTCACTTTTGC
GGTCCAGCGGT -> GTCCAGCGGTA
GGTCCTAGTGC -> GTCCTAGTGCG
GGTCGAATTTA -> GTCGAATTTAA
GGTCGGGTTAT -> GTCGGGTTATG
GGTCGTGATTG -> GTCGTGATTGC
GGTCTCCACTG -> GTCTCCACTGA
GGTCTGGTAGA -> GTCTGGTAGAT
GGTGCCGTGCC -> GTGCCGTGCCG
GGTGGAGCGTT -> GTGGAGCGTTG
GGTGGATACTA -> GTGGATACTAA
GGTGTACGTTA -> GTGTACGTTAT
GGTGTCAGGAC -> GTGTCAGGACT
GGTGTGATCGA -> GTGTGATCGAC
GGTGTGGGTTA -> GTGTGGGTTAC
GGTTACCCTTC -> GTTACCCTTCA
GGTTATGGGAC -> GTTATGGGACG
GGTTCCACATT -> GTTCCACATTT
GGTTCGTAGGT -> GTTCGTAGGTC
GGTTGAGATAT -> GTTGAGATATT
GGTTTCCACCA -> GTTTCCACCAG
GGTTTGAAGTA -> GTTTGAAGTAT
GTAAAAGTTTA -> TAAAAGTTTAC
GTAACACTTTG -> TAACACTTTGA
GTAACCGGGCT -> TAACCGGGCTC
GTAACTGCCAC -> TAACTGCCACA
GTAAGCGAATA -> TAAGCGAATAC
GTACAACATAG -> TACAACATAGG
GTACACAGCCA -> TACACAGCCAT
GTACATTAATC -> TACATTAATCA
GTACCAACAGG -> TACCAACAGGC
GTACCATTGCT -> TACCATTGCTG
GTACCCAACCC -> TACCCAACCCG
GTACCTCGAGT -> TACCTCGAGTT
GTACGATTCTC -> TACGATTCTCC
GTACGGCCCGA -> TACGGCCCGAG
GTACGGTCACA -> TACGGTCACAT
GTACGTTATAA -> TACGTTATAAA
GTACTCTTAGA -> TACTCTTAGAG
GTACTGTCTCG -> TACTGTCTCGC
GTAGAACAAAG -> TAGAACAAAGG
GTAGACGAGAA -> TAGACGAGAAC
GTAGACTAAAA -> TAGACTAAAAG
GTAGATAAGAC -> TAGATAAGACT
GTAGCACACAC -> TAGCACACACG
GTAGCACGTTT -> TAGCACGTTTC
GTAGCGTACAC -> TAGCGTACACA
GTAGCTGCTGC -> TAGCTGCTGCC
GTAGCTGCTGG -> TAGCTGCTGGT
GTAGGTACGAT -> TAGGTACGATT
GTAGGTCCAGC -> TAGGTCCAGCG
GTAGGTGTCAG -> TAGGTGTCAGG
GTAGTGCCAGA -> TAGTGCCAGAT
GTATCAGTACT -> TATCAGTACTG
GTATGGCAAGC -> TATGGCAAGCT
GTATGTGCGTT -> TATGTGCGTTT
GTATTAGTGAG -> TATTAGTGAGG
GTATTCAACGT -> TATTCAACGTA
GTATTCGACTA -> TATTCGACTAT
GTATTGATTGT -> TATTGATTGTC
GTCAAAAGATG -> TCAAAAGATGA
GTCAATGAGCT -> TCAATGAGCTC
GTCAATTCTGA -> TCAATTCTGAT
GTCACATATAT -> TCACATATATG
GTCACCTGGCC -> TCACCTGGCCG
GTCACTTTTGC -> TCACTTTTGCT
GTCAGACTCAC -> TCAGACTCACT
GTCAGGACTCA -> TCAGGACTCAC
GTCCAACACAC -> TCCAACACACC
GTCCAAGTGCT -> TCCAAGTGCTC
GTCCACTTCGC -> TCCACTTCGCC
GTCCAGCGGTA -> TCCAGCGGTAT
GTCCGGCCTCA -> TCCGGCCTCAG
GTCCTAGCTTA -> TCCTAGCTTAT
GTCCTAGTGCG -> TCCTAGTGCGT
GTCCTGGGCGA -> TCCTGGGCGAC
GTCCTTTAAAA -> TCCTTTAAAAG
GTCGAATTTAA -> TCGAATTTAAT
GTCGCTCATGA -> TCGCTCATGAT
GTCGGGTTATG -> TCGGGTTATGG
GTCGGTTCGTA -> TCGGTTCGTAG
GTCGTAGGTAC -> TCGTAGGTACG
GTCGTGATTGC -> TCGTGATTGCT
GTCTAACATTA -> TCTAACATTAC
GTCTCCACTGA -> TCTCCACTGAG
GTCTCCATGTG -> TCTCCATGTGG
GTCTCGACGAA -> TCTCGACGAAT
GTCTCGCGCTT -> TCTCGCGCTTT
GTCTGGTAGAT -> TCTGGTAGATA
GTCTTCATAGC -> TCTTCATAGCC
GTGAGGGGGCC -> TGAGGGGGCCT
GTGAGTGCTGT -> TGAGTGCTGTT
GTGATCGACAT -> TGATCGACATA
GTGATTGCTGC -> TGATTGCTGCA
GTGATTGGTAG -> TGATTGGTAGT
GTGCATTGGAC -> TGCATTGGACT
GTGCCAGATGG -> TGCCAGATGGG
GTGCCGGTCAA -> TGCCGGTCAAT
GTGCCGTGCCG -> TGCCGTGCCGG
GTGCGACGTAC -> TGCGACGTACC
GTGCGCGCCAG -> TGCGCGCCAGG
GTGCGTCAATT -> TGCGTCAATTC
GTGCGTTTAAT -> TGCGTTTAATT
GTGCTCAGTCT -> TGCTCAGTCTC
GTGCTGTTAAA -> TGCTGTTAAAC
GTGGAGCGTTG -> TGGAGCGTTGG
GTGGATACTAA -> TGGATACTAAG
GTGGCCGATAT -> TGGCCGATATG
GTGGGTTACCC -> TGGGTTACCCT
GTGGGTTGAGA -> TGGGTTGAGAT
GTGTAAGCGAA -> TGTAAGCGAAT
GTGTACCTCGA -> TGTACCTCGAG
GTGTACGTTAT -> TGTACGTTATA
GTGTAGACTAA -> TGTAGACTAAA
GTGTCAGGACT -> TGTCAGGACTC
GTGTGATCGAC -> TGTGATCGACA
GTGTGCGCGCC -> TGTGCGCGCCA
GTGTGGGTTAC -> TGTGGGTTACC
GTTAAACAAAG -> TTAAACAAAGC
GTTAAACAGAC -> TTAAACAGACA
GTTAAGATGAC -> TTAAGATGACT
GTTAAGGAGGG -> TTAAGGAGGGA
GTTAATGCATG -> TTAATGCATGT
GTTACACATAC -> TTACACATACC
GTTACCCTTCA -> TTACCCTTCAA
GTTACTCGTGA -> TTACTCGTGAG
GTTATAAAAAC -> TTATAAAAACG
GTTATACTTCC -> TTATACTTCCG
GTTATAGTTAT -> TTATAGTTATA
GTTATGGGACG -> TTATGGGACGA
GTTCCACATTT -> TTCCACATTTC
GTTCGTAGGTC -> TTCGTAGGTCC
GTTCTACAGAT -> TTCTACAGATG
GTTCTACCGAT -> TTCTACCGATC
GTTGAGATATT -> TTGAGATATTG
GTTGGTGTACG -> TTGGTGTACGT
GTTGTTATAGT -> TTGTTATAGTT
GTTTAATTACG -> TTTAATTACGG
GTTTAATTACT -> TTTAATTACTA
GTTTACTACGT -> TTTACTACGTG
GTTTCCACCAG -> TTTCCACCAGA
GTTTCTGACCC -> TTTCTGACCCT
GTTTGAAGTAT -> TTTGAAGTATG
GTTTGTCCAAC -> TTTGTCCAACA
TAAAAACGTAA -> AAAAACGTAAC
TAAAACCAGAT -> AAAACCAGATG
TAAAAGGTGTG -> AAAAGGTGTGA
TAAAAGTCAAA -> AAAAGTCAAAA
TAAAAGTTTAC -> AAAAGTTTACT
TAAACAAAGCG -> AAACAAAGCGT
TAAACAGACAC -> AAACAGACACT
TAAACCTGCAG -> AAACCTGCAGG
TAAACGCGCCG -> AAACGCGCCGT
TAACACTTTGA -> AACACTTTGAT
TAACATTACAT -> AACATTACATC
TAACCGGGCTC -> AACCGGGCTCT
TAACTAGTACA -> AACTAGTACAA
TAACTGCCACA -> AACTGCCACAT
TAAGACCTTCA -> AAGACCTTCAT
TAAGACTCCAA -> AAGACTCCAAT
TAAGATAGCAG -> AAGATAGCAGG
TAAGATGACTG -> AAGATGACTGA
TAAGCGAATAC -> AAGCGAATACC
TAAGCTACTAT -> AAGCTACTATC
TAAGGAAGAAA -> AAGGAAGAAAT
TAAGGAGGGAT -> AAGGAGGGATC
TAAGGCTCGTC -> AAGGCTCGTCC
TAAGTGGCCGA -> AAGTGGCCGAT
TAATCACCACG -> AATCACCACGT
TAATCACCACT -> AATCACCACTA
TAATGCATGTC -> AATGCATGTCT
TAATTACGGAC -> AATTACGGACA
TAATTACTAGC -> AATTACTAGCG
TAATTCACACG -> AATTCACACGA
TACAAATTTTT -> ACAAATTTTTC
TACAACATAGG -> ACAACATAGGA
TACACACTCAA -> ACACACTCAAG
TACACAGCCAT -> ACACAGCCATA
TACACATACCT -> ACACATACCTG
TACACGGGTCG -> ACACGGGTCGG
TACAGATGGTA -> ACAGATGGTAT
TACATCCGGGA -> ACATCCGGGAT
TACATTAATCA -> ACATTAATCAC
TACCAACAGGC -> ACCAACAGGCT
TACCAAGAGAC -> ACCAAGAGACT
TACCATTCCTA -> ACCATTCCTAT
TACCATTGCTG -> ACCATTGCTGC
TACCCAACCCG -> ACCCAACCCGG
TACCCACTCCG -> ACCCACTCCGG
TACCCCCTGCG -> ACCCCCTGCGA
TACCCTTCAAT -> ACCCTTCAATG
TACCGATCAGA -> ACCGATCAGAA
TACCTCGAGTT -> ACCTCGAGTTA
TACCTGTACGG -> ACCTGTACGGT
TACCTTATAAT -> ACCTTATAATT
TACGAACCATC -> ACGAACCATCC
TACGAATTAAC -> ACGAATTAACT
TACGATTCTCC -> ACGATTCTCCG
TACGGACAAAG -> ACGGACAAAGG
TACGGCCCGAG -> ACGGCCCGAGG
TACGGTCACAT -> ACGGTCACATA
TACGTGTAGAC -> ACGTGTAGACT
TACGTTATAAA -> ACGTTATAAAA
TACTAAGGAAG -> ACTAAGGAAGA
TACTACGTGTA -> ACTACGTGTAG
TACTAGCGCTG -> ACTAGCGCTGC
TACTATAGTTG -> ACTATAGTTGT
TACTATCTTAT -> ACTATCTTATT
TACTCGAAGTT -> ACTCGAAGTTA
TACTCGTGAGT -> ACTCGTGAGTG
TACTCTTAGAG -> ACTCTTAGAGC
TACTGTCTCGC -> ACTGTCTCGCG
TACTTCCGCAG -> ACTTCCGCAGT
TACTTTGTACC -> ACTTTGTACCC
TAGAACAAAGG -> AGAACAAAGGT
TAGACCTGCAT -> AGACCTGCATA
TAGACGAGAAC -> AGACGAGAACT
TAGACTAAAAG -> AGACTAAAAGG
TAGAGCCAGCA -> AGAGCCAGCAG
TAGAGTAGCAC -> AGAGTAGCACA
TAGATAAGACT -> AGATAAGACTC
TAGATAGTGAT -> AGATAGTGATT
TAGATCTGGAA -> AGATCTGGAAC
TAGATGAGACA -> AGATGAGACAA
TAGCACACACG -> AGCACACACGA
TAGCACGTTTC -> AGCACGTTTCT
TAGCAGGGCCG -> AGCAGGGCCGA
TAGCCCTACCC -> AGCCCTACCCC
TAGCCGGTCGA -> AGCCGGTCGAA
TAGCCTGGACA -> AGCCTGGACAC
TAGCGAATACT -> AGCGAATACTT
TAGCGCAAGTA -> AGCGCAAGTAC
TAGCGCTGCGT -> AGCGCTGCGTC
TAGCGTACACA -> AGCGTACACAG
TAGCTGCTGCC -> AGCTGCTGCCC
TAGCTGCTGGT -> AGCTGCTGGTG
TAGCTTATCCC -> AGCTTATCCCT
TAGGAAACCCG -> AGGAAACCCGT
TAGGACCAGAT -> AGGACCAGATG
TAGGATTCGTG -> AGGATTCGTGT
TAGGTACATTA -> AGGTACATTAA
TAGGTACGATT -> AGGTACGATTC
TAGGTCCAGCG -> AGGTCCAGCGG
TAGGTGTCAGG -> AGGTGTCAGGA
TAGTACAACAT -> AGTACAACATA
TAGTAGGTGTC -> AGTAGGTGTCA
TAGTCAGACTC -> AGTCAGACTCA
TAGTGAGGGGG -> AGTGAGGGGGC
TAGTGATTGGT -> AGTGATTGGTA
TAGTGCCAGAT -> AGTGCCAGATG
TAGTGCGTCAA -> AGTGCGTCAAT
TAGTTATACTT -> AGTTATACTTC
TAGTTGTTATA -> AGTTGTTATAG
TATAAAAACGT -> ATAAAAACGTA
TATAAAACCAG -> ATAAAACCAGA
TATAAGACCTT -> ATAAGACCTTC
TATAATTCACA -> ATAATTCACAC
TATACTTCCGC -> ATACTTCCGCA
TATAGTCAGAC -> ATAGTCAGACT
TATAGTTATAC -> ATAGTTATACT
TATAGTTGTTA -> ATAGTTGTTAT
TATATGGCAGG -> ATATGGCAGGA
TATCAGTACTG -> ATCAGTACTGT
TATCCCTCTTG -> ATCCCTCTTGA
TATCCGGGTAA -> ATCCGGGTAAC
TATCGGAAGCG -> ATCGGAAGCGA
TATCTAGATCT -> ATCTAGATCTG
TATCTTATTAC -> ATCTTATTACT
TATGATAGATA -> ATGATAGATAG
TATGGCAAGCT -> ATGGCAAGCTA
TATGGCAGGAC -> ATGGCAGGACT
TATGGGACGAT -> ATGGGACGATT
TATGGTATTAG -> ATGGTATTAGT
TATGTGCGTTT -> ATGTGCGTTTA
TATGTGTACCT -> ATGTGTACCTC
TATTACTCGAA -> ATTACTCGAAG
TATTAGTGAGG -> ATTAGTGAGGG
TATTATAAAAC -> ATTATAAAACC
TATTCAACGTA -> ATTCAACGTAG
TATTCCGCGGT -> ATTCCGCGGTG
TATTCGACTAT -> ATTCGACTATC
TATTCGAGAGC -> ATTCGAGAGCG
TATTGAAGTCC -> ATTGAAGTCCT
TATTGATTGTC -> ATTGATTGTCG
TATTTATTCGA -> ATTTATTCGAG
TCAAAAGATGA -> CAAAAGATGAA
TCAACATCGTC -> CAACATCGTCC
TCAACGTAGAC -> CAACGTAGACG
TCAAGCTGAAC -> CAAGCTGAACG
TCAATGAAGAA -> CAATGAAGAAA
TCAATGAGCTC -> CAATGAGCTCC
TCAATTAAGTG -> CAATTAAGTGG
TCAATTCTGAT -> CAATTCTGATC
TCAATTGGTTT -> CAATTGGTTTG
TCACACGAGGG -> CACACGAGGGG
TCACATATATG -> CACATATATGG
TCACCACGTAG -> CACCACGTAGA
TCACCACTAGA -> CACCACTAGAT
TCACCGGTTCC -> CACCGGTTCCA
TCACCTGGCCG -> CACCTGGCCGT
TCACGACTGAT -> CACGACTGATG
TCACGTAGCGT -> CACGTAGCGTA
TCACTTATTAT -> CACTTATTATA
TCACTTTTGCT -> CACTTTTGCTT
TCAGAATAGGA -> CAGAATAGGAA
TCAGACTCACT -> CAGACTCACTT
TCAGGACTCAC -> CAGGACTCACG
TCAGTACTGTC -> CAGTACTGTCT
TCAGTCCAAGT -> CAGTCCAAGTG
TCAGTCCTAGC -> CAGTCCTAGCT
TCAGTCTCCAT -> CAGTCTCCATG
TCAGTCTCGAC -> CAGTCTCGACG
TCATAGCCCTA -> CATAGCCCTAC
TCATAGCCTGG -> CATAGCCTGGA
TCATAGCGAAT -> CATAGCGAATA
TCATATAGTCA -> CATATAGTCAG
TCATCGAGACC -> CATCGAGACCA
TCATGATACAA -> CATGATACAAA
TCATTGGTAGC -> CATTGGTAGCT
TCCAACACACC -> CCAACACACCA
TCCAACTACCA -> CCAACTACCAA
TCCAAGTGCTC -> CCAAGTGCTCA
TCCAATGGGTG -> CCAATGGGTGG
TCCACATTTCA -> CCACATTTCAA
TCCACCAGAGT -> CCACCAGAGTT
TCCACTGAGGC -> CCACTGAGGCT
TCCACTTCGCC -> CCACTTCGCCA
TCCAGCGGTAT -> CCAGCGGTATC
TCCAGTTAAGA -> CCAGTTAAGAT
TCCATACCCAC -> CCATACCCACT
TCCATCTGAGG -> CCATCTGAGGC
TCCATGTGGGT -> CCATGTGGGTT
TCCCTCTTGAA -> CCCTCTTGAAG
TCCGCAGATTC -> CCGCAGATTCG
TCCGCAGTTAC -> CCGCAGTTACT
TCCGCCGACGG -> CCGCCGACGGT
TCCGCGGTGCC -> CCGCGGTGCCG
TCCGGCCTCAG -> CCGGCCTCAGT
TCCGGCTAGCG -> CCGGCTAGCGC
TCCGGGATCTA -> CCGGGATCTAC
TCCGGGCAGCG -> CCGGGCAGCGA
TCCGGGTAACA -> CCGGGTAACAC
TCCTAGCTTAT -> CCTAGCTTATC
TCCTAGTAGGT -> CCTAGTAGGTG
TCCTAGTGCGT -> CCTAGTGCGTC
TCCTATCGGAA -> CCTATCGGAAG
TCCTCACCGGT -> CCTCACCGGTT
TCCTCGTTCTA -> CCTCGTTCTAC
TCCTGGGCGAC -> CCTGGGCGACA
TCCTTTAAAAG -> CCTTTAAAAGT
TCGAAGTTAAA -> CGAAGTTAAAC
TCGAATTTAAT -> CGAATTTAATC
TCGACATAGGT -> CGACATAGGTA
TCGACGAATGT -> CGACGAATGTA
TCGACTATCCG -> CGACTATCCGG
TCGACTCGCCG -> CGACTCGCCGT
TCGAGACCAAT -> CGAGACCAATC
TCGAGAGCGCC -> CGAGAGCGCCA
TCGAGGGAGAA -> CGAGGGAGAAA
TCGAGTTAAGG -> CGAGTTAAGGA
TCGCCAGCACC -> CGCCAGCACCC
TCGCCGTATTC -> CGCCGTATTCA
TCGCGCTTTTA -> CGCGCTTTTAG
TCGCTCATGAT -> CGCTCATGATA
TCGGAAGCGAT -> CGGAAGCGATC
TCGGACCCTCA -> CGGACCCTCAG
TCGGCAAAGGG -> CGGCAAAGGGG
TCGGCATCCTA -> CGGCATCCTAG
TCGGGGGCTGC -> CGGGGGCTGCG
TCGGGTTATGG -> CGGGTTATGGG
TCGGTTCGTAG -> CGGTTCGTAGG
TCGGTTTCCAC -> CGGTTTCCACC
TCGTAAAAGTT -> CGTAAAAGTTT
TCGTAGGTACG -> CGTAGGTACGA
TCGTAGGTCCA -> CGTAGGTCCAG
TCGTCCACTTC -> CGTCCACTTCG
TCGTCCGGCCT -> CGTCCGGCCTC
TCGTGAGTGCT -> CGTGAGTGCTG
TCGTGATTGCT -> CGTGATTGCTG
TCGTGTAAGCG -> CGTGTAAGCGA
TCGTTAATGCA -> CGTTAATGCAT
TCGTTCTACAG -> CGTTCTACAGA
TCTAACATTAC -> CTAACATTACA
TCTACAGATGG -> CTACAGATGGT
TCTACCGATCA -> CTACCGATCAG
TCTACCTTATA -> CTACCTTATAA
TCTAGATCTGG -> CTAGATCTGGA
TCTATGATAGA -> CTATGATAGAT
TCTATGTGTAC -> CTATGTGTACC
TCTCCACTGAG -> CTCCACTGAGG
TCTCCATGTGG -> CTCCATGTGGG
TCTCCGGGCAG -> CTCCGGGCAGC
TCTCCTCACCG -> CTCCTCACCGG
TCTCGACGAAT -> CTCGACGAATG
TCTCGCGCTTT -> CTCGCGCTTTT
TCTCGGTTTCC -> CTCGGTTTCCA
TCTGACCCTCA -> CTGACCCTCAC
TCTGACTATTT -> CTGACTATTTA
TCTGAGGCAAC -> CTGAGGCAACC
TCTGATCTTGA -> CTGATCTTGAA
TCTGGAACCGG -> CTGGAACCGGT
TCTGGTAGATA -> CTGGTAGATAA
TCTTAGAGCCA -> CTTAGAGCCAG
TCTTATTACTC -> CTTATTACTCG
TCTTCATAGCC -> CTTCATAGCCC
TCTTGAAATAG -> CTTGAAATAGA
TCTTGAAGCCG -> CTTGAAGCCGT
TGAAATAGAGT -> GAAATAGAGTA
TGAACGGCTCA -> GAACGGCTCAT
TGAAGAAAGGA -> GAAGAAAGGAG
TGAAGACCAAA -> GAAGACCAAAC
TGAAGACGGCT -> GAAGACGGCTC
TGAAGCCGTGC -> GAAGCCGTGCA
TGAAGTATGTG -> GAAGTATGTGC
TGAAGTCCTTT -> GAAGTCCTTTA
TGACCAATGGG -> GACCAATGGGA
TGACCCTCACG -> GACCCTCACGA
TGACCGTCGTA -> GACCGTCGTAG
TGACTATTTAT -> GACTATTTATT
TGACTGACCGT -> GACTGACCGTC
TGAGACAACAG -> GAGACAACAGA
TGAGATATTGA -> GAGATATTGAA
TGAGCTCCGCA -> GAGCTCCGCAG
TGAGGATCTAT -> GAGGATCTATG
TGAGGCAACCA -> GAGGCAACCAG
TGAGGCTTTTA -> GAGGCTTTTAC
TGAGGGGGCCT -> GAGGGGGCCTG
TGAGTGCTGTT -> GAGTGCTGTTA
TGATACAAATT -> GATACAAATTT
TGATAGATAGT -> GATAGATAGTG
TGATCGACATA -> GATCGACATAG
TGATCTTGAAA -> GATCTTGAAAT
TGATGGTCACT -> GATGGTCACTT
TGATTCATATA -> GATTCATATAG
TGATTGCTGCA -> GATTGCTGCAA
TGATTGGTAGT -> GATTGGTAGTG
TGATTGTCGCT -> GATTGTCGCTC
TGCAAATACTA -> GCAAATACTAT
TGCACAGATGT -> GCACAGATGTT
TGCAGGTGGAT -> GCAGGTGGATA
TGCATACGAAT -> GCATACGAATT
TGCATGTCTAA -> GCATGTCTAAC
TGCATTGGACT -> GCATTGGACTA
TGCCACATCAG -> GCCACATCAGT
TGCCAGATGGG -> GCCAGATGGGC
TGCCAGGGCCG -> GCCAGGGCCGG
TGCCCTTATTC -> GCCCTTATTCC
TGCCGGTCAAT -> GCCGGTCAATG
TGCCGTGCCGG -> GCCGTGCCGGT
TGCGACGTACC -> GCGACGTACCA
TGCGATCTGAC -> GCGATCTGACT
TGCGCATAAGA -> GCGCATAAGAT
TGCGCGCCAGG -> GCGCGCCAGGG
TGCGGTCACCT -> GCGGTCACCTG
TGCGTCAATTC -> GCGTCAATTCT
TGCGTCCTGGG -> GCGTCCTGGGC
TGCGTTTAATT -> GCGTTTAATTA
TGCTCAGTCTC -> GCTCAGTCTCC
TGCTGCAAATA -> GCTGCAAATAC
TGCTGCACAGA -> GCTGCACAGAT
TGCTGCCCTTA -> GCTGCCCTTAT
TGCTGGTGTGG -> GCTGGTGTGGG
TGCTGTTAAAC -> GCTGTTAAACA
TGCTTCGTTAA -> GCTTCGTTAAT
TGGAACCGGTA -> GGAACCGGTAC
TGGACACCTAA -> GGACACCTAAG
TGGACTATAAG -> GGACTATAAGA
TGGAGCGTTGG -> GGAGCGTTGGT
TGGATACTAAG -> GGATACTAAGG
TGGCAAATACG -> GGCAAATACGA
TGGCAAGCTAA -> GGCAAGCTAAA
TGGCAGGACTG -> GGCAGGACTGC
TGGCCGATATG -> GGCCGATATGG
TGGCCGCTAGA -> GGCCGCTAGAC
TGGCCGTCTTC -> GGCCGTCTTCA
TGGCGCTACAC -> GGCGCTACACG
TGGGACGATTC -> GGGACGATTCT
TGGGAGGCACT -> GGGAGGCACTG
TGGGCAGTGTG -> GGGCAGTGTGC
TGGGCGACAAG -> GGGCGACAAGG
TGGGTGGAGCG -> GGGTGGAGCGT
TGGGTTACCCT -> GGGTTACCCTT
TGGGTTGAGAT -> GGGTTGAGATA
TGGTAGATAAG -> GGTAGATAAGA
TGGTAGCTGCT -> GGTAGCTGCTG
TGGTAGTGCCA -> GGTAGTGCCAG
TGGTATTAGTG -> GGTATTAGTGA
TGGTATTGATT -> GGTATTGATTG
TGGTCACTTTT -> GGTCACTTTTG
TGGTGTACGTT -> GGTGTACGTTA
TGGTGTGGGTT -> GGTGTGGGTTA
TGGTTTGAAGT -> GGTTTGAAGTA
TGTAAGCGAAT -> GTAAGCGAATA
TGTACCCAACC -> GTACCCAACCC
TGTACCTCGAG -> GTACCTCGAGT
TGTACGGTCAC -> GTACGGTCACA
TGTACGTTATA -> GTACGTTATAA
TGTAGACTAAA -> GTAGACTAAAA
TGTAGCTGCTG -> GTAGCTGCTGC
TGTCAGGACTC -> GTCAGGACTCA
TGTCCAACACA -> GTCCAACACAC
TGTCGCTCATG -> GTCGCTCATGA
TGTCGGTTCGT -> GTCGGTTCGTA
TGTCTAACATT -> GTCTAACATTA
TGTCTCGCGCT -> GTCTCGCGCTT
TGTGATCGACA -> GTGATCGACAT
TGTGCGCGCCA -> GTGCGCGCCAG
TGTGCGTTTAA -> GTGCGTTTAAT
TGTGGGTTACC -> GTGGGTTACCC
TGTGGGTTGAG -> GTGGGTTGAGA
TGTGTACCTCG -> GTGTACCTCGA
TGTTAAACAGA -> GTTAAACAGAC
TGTTATAGTTA -> GTTATAGTTAT
TGTTTGTCCAA -> GTTTGTCCAAC
TTAAAAGTCAA -> TAAAAGTCAAA
TTAAACAAAGC -> TAAACAAAGCG
TTAAACAGACA -> TAAACAGACAC
TTAACTAGTAC -> TAACTAGTACA
TTAAGATGACT -> TAAGATGACTG
TTAAGGAGGGA -> TAAGGAGGGAT
TTAAGTGGCCG -> TAAGTGGCCGA
TTAATCACCAC -> TAATCACCACT,TAATCACCACG
TTAATGCATGT -> TAATGCATGTC
TTAATTACGGA -> TAATTACGGAC
TTAATTACTAG -> TAATTACTAGC
TTACACACTCA -> TACACACTCAA
TTACACATACC -> TACACATACCT
TTACATCCGGG -> TACATCCGGGA
TTACCCTTCAA -> TACCCTTCAAT
TTACGGACAAA -> TACGGACAAAG
TTACTACGTGT -> TACTACGTGTA
TTACTAGCGCT -> TACTAGCGCTG
TTACTCGAAGT -> TACTCGAAGTT
TTACTCGTGAG -> TACTCGTGAGT
TTAGAGCCAGC -> TAGAGCCAGCA
TTAGCCGGTCG -> TAGCCGGTCGA
TTAGTGAGGGG -> TAGTGAGGGGG
TTATAAAAACG -> TATAAAAACGT
TTATAAAACCA -> TATAAAACCAG
TTATAATTCAC -> TATAATTCACA
TTATACTTCCG -> TATACTTCCGC
TTATAGTTATA -> TATAGTTATAC
TTATCCCTCTT -> TATCCCTCTTG
TTATGGGACGA -> TATGGGACGAT
TTATTACTCGA -> TATTACTCGAA
TTATTATAAAA -> TATTATAAAAC
TTATTCCGCGG -> TATTCCGCGGT
TTATTCGAGAG -> TATTCGAGAGC
TTCAACATCGT -> TCAACATCGTC
TTCAACGTAGA -> TCAACGTAGAC
TTCAATGAAGA -> TCAATGAAGAA
TTCAATTAAGT -> TCAATTAAGTG
TTCACACGAGG -> TCACACGAGGG
TTCATAGCCCT -> TCATAGCCCTA
TTCATAGCCTG -> TCATAGCCTGG
TTCATAGCGAA -> TCATAGCGAAT
TTCATATAGTC -> TCATATAGTCA
TTCCACATTTC -> TCCACATTTCA
TTCCACCAGAG -> TCCACCAGAGT
TTCCAGTTAAG -> TCCAGTTAAGA
TTCCATACCCA -> TCCATACCCAC
TTCCGCAGTTA -> TCCGCAGTTAC
TTCCGCGGTGC -> TCCGCGGTGCC
TTCCTATCGGA -> TCCTATCGGAA
TTCGACTATCC -> TCGACTATCCG
TTCGAGAGCGC -> TCGAGAGCGCC
TTCGAGGGAGA -> TCGAGGGAGAA
TTCGCCAGCAC -> TCGCCAGCACC
TTCGTAGGTCC -> TCGTAGGTCCA
TTCGTGTAAGC -> TCGTGTAAGCG
TTCGTTAATGC -> TCGTTAATGCA
TTCTACAGATG -> TCTACAGATGG
TTCTACCGATC -> TCTACCGATCA
TTCTCCGGGCA -> TCTCCGGGCAG
TTCTCGGTTTC -> TCTCGGTTTCC
TTCTGACCCTC -> TCTGACCCTCA
TTCTGATCTTG -> TCTGATCTTGA
TTGAAATAGAG -> TGAAATAGAGT
TTGAAGACGGC -> TGAAGACGGCT
TTGAAGCCGTG -> TGAAGCCGTGC
TTGAAGTATGT -> TGAAGTATGTG
TTGAAGTCCTT -> TGAAGTCCTTT
TTGAGATATTG -> TGAGATATTGA
TTGATTCATAT -> TGATTCATATA
TTGATTGTCGC -> TGATTGTCGCT
TTGCTGCAAAT -> TGCTGCAAATA
TTGCTGCACAG -> TGCTGCACAGA
TTGCTTCGTTA -> TGCTTCGTTAA
TTGGACTATAA -> TGGACTATAAG
TTGGCGCTACA -> TGGCGCTACAC
TTGGTAGCTGC -> TGGTAGCTGCT
TTGGTAGTGCC -> TGGTAGTGCCA
TTGGTGTACGT -> TGGTGTACGTT
TTGGTTTGAAG -> TGGTTTGAAGT
TTGTACCCAAC -> TGTACCCAACC
TTGTCCAACAC -> TGTCCAACACA
TTGTCGCTCAT -> TGTCGCTCATG
TTGTTATAGTT -> TGTTATAGTTA
TTTAAAAGTCA -> TTAAAAGTCAA
TTTAATCACCA -> TTAATCACCAC
TTTAATTACGG -> TTAATTACGGA
TTTAATTACTA -> TTAATTACTAG
TTTACACACTC -> TTACACACTCA
TTTACTACGTG -> TTACTACGTGT
TTTAGCCGGTC -> TTAGCCGGTCG
TTTATTCGAGA -> TTATTCGAGAG
TTTCAACATCG -> TTCAACATCGT
TTTCAATTAAG -> TTCAATTAAGT
TTTCATAGCCT -> TTCATAGCCTG
TTTCCACCAGA -> TTCCACCAGAG
TTTCTGACCCT -> TTCTGACCCTC
TTTGAAGTATG -> TTGAAGTATGT
TTTGATTCATA -> TTGATTCATAT
TTTGCTTCGTT -> TTGCTTCGTTA
TTTGTACCCAA -> TTGTACCCAAC
TTTGTCCAACA -> TTGTCCAACAC
TTTTACACACT -> TTTACACACTC
TTTTAGCCGGT -> TTTAGCCGGTC
TTTTCATAGCC -> TTTCATAGCCT
TTTTGCTTCGT -> TTTGCTTCGTT
TTTTTCATAGC -> TTTTCATAGCC
