AAAAAAATCTGAACACGTA -> AAAAAATCTGAACACGTAA
AAAAAATCTGAACACGTAA -> AAAAATCTGAACACGTAAA
AAAAATCTGAACACGTAAA -> AAAATCTGAACACGTAAAT
AAAACCGCGCGAAAATCGG -> AAACCGCGCGAAAATCGGC
AAAACCTACTGAATCGATC -> AAACCTACTGAATCGATCG
AAAACTGCGAGTAGTTTAT -> AAACTGCGAGTAGTTTATG
AAAATCCCGAGGAGCCGCG -> AAATCCCGAGGAGCCGCGC
AAAATCCGGATAGGCCCAC -> AAATCCGGATAGGCCCACT
AAAATCGGCTTCGCGTATG -> AAATCGGCTTCGCGTATGA
AAAATCTGAACACGTAAAT -> AAATCTGAACACGTAAATT
AAAATTGCCCTGGGCTTCA -> AAATTGCCCTGGGCTTCAA
AAACCAGGCTCTTGTCTTC -> AACCAGGCTCTTGTCTTCA
AAACCCTGTCTGCAGCGTA -> AACCCTGTCTGCAGCGTAT
AAACCGCGCGAAAATCGGC -> AACCGCGCGAAAATCGGCT
AAACCGTACGTCTTAAGAC -> AACCGTACGTCTTAAGACA
AAACCTACTGAATCGATCG -> AACCTACTGAATCGATCGA
AAACTAGAGGGCCTTCTTA -> AACTAGAGGGCCTTCTTAT
AAACTATTGAAATCTTCAG -> AACTATTGAAATCTTCAGC
AAACTGCGAGTAGTTTATG -> AACTGCGAGTAGTTTATGC
AAAGAACTGGCATTGCCAT -> AAGAACTGGCATTGCCATG
AAAGATCAAAGAACTGGCA -> AAGATCAAAGAACTGGCAT
AAAGCAATCCTTAGAGGCT -> AAGCAATCCTTAGAGGCTG
AAAGGAAGTGTACGTGACG -> AAGGAAGTGTACGTGACGC
AAAGTATATCTTAGGATGT -> AAGTATATCTTAGGATGTC
AAAGTCTTCCGCTTCAATT -> AAGTCTTCCGCTTCAATTT
AAATCCCGAGGAGCCGCGC -> AATCCCGAGGAGCCGCGCC
AAATCCGGATAGGCCCACT -> AATCCGGATAGGCCCACTT
AAATCGGCTTCGCGTATGA -> AATCGGCTTCGCGTATGAC
AAATCTGAACACGTAAATT -> AATCTGAACACGTAAATTA
AAATCTTCAGCTAGAATGC -> AATCTTCAGCTAGAATGCT
AAATGTGTGCTCGGGTTAC -> AATGTGTGCTCGGGTTACT
AAATTAATTGTACGCTACG -> AATTAATTGTACGCTACGT
AAATTATCTGATTGGTTAG -> AATTATCTGATTGGTTAGC
AAATTGCCCTGGGCTTCAA -> AATTGCCCTGGGCTTCAAC
AACAAAACCGCGCGAAAAT -> ACAAAACCGCGCGAAAATC
AACAAGATGTTCGGCAGGA -> ACAAGATGTTCGGCAGGAG
AACAATCGACCAAGCTTTG -> ACAATCGACCAAGCTTTGC
AACAATTAAGAGTAGTTTT -> ACAATTAAGAGTAGTTTTC
AACACGTAAATTAATTGTA -> ACACGTAAATTAATTGTAC
AACAGAAGGGGCTCCTCGG -> ACAGAAGGGGCTCCTCGGT
AACCAGGCTCTTGTCTTCA -> ACCAGGCTCTTGTCTTCAC
AACCCACAAACTATTGAAA -> ACCCACAAACTATTGAAAT
AACCCTGTCTGCAGCGTAT -> ACCCTGTCTGCAGCGTATG
AACCGAAACCAGGCTCTTG -> ACCGAAACCAGGCTCTTGT
AACCGAGCACCTACGTTGA -> ACCGAGCACCTACGTTGAT
AACCGCGCGAAAATCGGCT -> ACCGCGCGAAAATCGGCTT
AACCGTACGTCTTAAGACA -> ACCGTACGTCTTAAGACAG
AACCTACTGAATCGATCGA -> ACCTACTGAATCGATCGAT
AACCTAGACTGCTGACACC -> ACCTAGACTGCTGACACCA
AACCTCCATATCTTTAAGA -> ACCTCCATATCTTTAAGAT
AACCTCCTGTAAGACATGA -> ACCTCCTGTAAGACATGAT
AACCTGTAGCGGCGCCCTG -> ACCTGTAGCGGCGCCCTGG
AACGAGAAGAGGTGTGTAA -> ACGAGAAGAGGTGTGTAAA
AACGCCTACTGAATCGATC -> ACGCCTACTGAATCGATCG
AACGGATATAAAATCCGGA -> ACGGATATAAAATCCGGAT
AACGGCATAGGGGCATTCG -> ACGGCATAGGGGCATTCGC
AACGGGCAGTCAATTTAGT -> ACGGGCAGTCAATTTAGTC
AACGTACTTAGAACAATTA -> ACGTACTTAGAACAATTAA
AACTAAACCGTACGTCTTA -> ACTAAACCGTACGTCTTAA
AACTAGAGGGCCTTCTTAT -> ACTAGAGGGCCTTCTTATC
AACTATTGAAATCTTCAGC -> ACTATTGAAATCTTCAGCT
AACTCATGAGAAGTCTGTG -> ACTCATGAGAAGTCTGTGT
AACTCCATTCGTTTATTAG -> ACTCCATTCGTTTATTAGA
AACTGCGAGTAGTTTATGC -> ACTGCGAGTAGTTTATGCC
AACTGGCATTGCCATGTCA -> ACTGGCATTGCCATGTCAC
AACTTGGGTTACTGAATCG -> ACTTGGGTTACTGAATCGA
AAGAACTGGCATTGCCATG -> AGAACTGGCATTGCCATGT
AAGACAGCAACCTGTAGCG -> AGACAGCAACCTGTAGCGG
AAGACATGATCATCGGACA -> AGACATGATCATCGGACAC
AAGACCAACAAAACCGCGC -> AGACCAACAAAACCGCGCG
AAGACCCTTCATACACGTA -> AGACCCTTCATACACGTAC
AAGACTGGCGCCGCACGGA -> AGACTGGCGCCGCACGGAC
AAGACTGTATAGCGATAAC -> AGACTGTATAGCGATAACT
AAGAGGTGTGTAAACCCTG -> AGAGGTGTGTAAACCCTGT
AAGAGTAGTTTTCTTTTCA -> AGAGTAGTTTTCTTTTCAA
AAGATAATTGAGCCCTAGT -> AGATAATTGAGCCCTAGTA
AAGATATCAGATGGAGACT -> AGATATCAGATGGAGACTC
AAGATCAAAGAACTGGCAT -> AGATCAAAGAACTGGCATT
AAGATGTTCGGCAGGAGCC -> AGATGTTCGGCAGGAGCCA
AAGCAATCCTTAGAGGCTG -> AGCAATCCTTAGAGGCTGA
AAGCAGGTTATCTGGGGCG -> AGCAGGTTATCTGGGGCGC
AAGCATCCTCTGATCCTGG -> AGCATCCTCTGATCCTGGC
AAGCCGGCACATCTTGCAT -> AGCCGGCACATCTTGCATA
AAGCGAATTCCAAGTGACG -> AGCGAATTCCAAGTGACGA
AAGCGAGGGCACTGACAGA -> AGCGAGGGCACTGACAGAT
AAGCTCATAGATTCGGCTT -> AGCTCATAGATTCGGCTTC
AAGGAAGTGTACGTGACGC -> AGGAAGTGTACGTGACGCG
AAGGGGCTCCTCGGTTAGC -> AGGGGCTCCTCGGTTAGCT
AAGGTCAAGACTGTATAGC -> AGGTCAAGACTGTATAGCG
AAGTAGACTGCTGACACCA -> AGTAGACTGCTGACACCAC
AAGTATATCTTAGGATGTC -> AGTATATCTTAGGATGTCA
AAGTCGCTCCTGGTAGCGC -> AGTCGCTCCTGGTAGCGCC
AAGTCTGTGTACTCCTGAG -> AGTCTGTGTACTCCTGAGC
AAGTCTTCCGCTTCAATTT -> AGTCTTCCGCTTCAATTTG
AAGTGACGACTAATTAAGT -> AGTGACGACTAATTAAGTA
AAGTGTACGTGACGCGTTG -> AGTGTACGTGACGCGTTGC
AAGTTATCTGATTAATATG -> AGTTATCTGATTAATATGC
AATAACGGATATAAAATCC -> ATAACGGATATAAAATCCG
AATAGGTAGAAAGCAATCC -> ATAGGTAGAAAGCAATCCT
AATATCGCTGTCAATTCTT -> ATATCGCTGTCAATTCTTC
AATATGCAGGTGCATCGGC -> ATATGCAGGTGCATCGGCT
AATATTCATAAGTCGCTCC -> ATATTCATAAGTCGCTCCT
AATCCCGAGGAGCCGCGCC -> ATCCCGAGGAGCCGCGCCA
AATCCGGATAGGCCCACTT -> ATCCGGATAGGCCCACTTC
AATCCTTAGAGGCTGACCC -> ATCCTTAGAGGCTGACCCT
AATCGATCGATCAAATTAT -> ATCGATCGATCAAATTATC
AATCGATCGATCAACCCAC -> ATCGATCGATCAACCCACA
AATCGATCGATCAACTCAT -> ATCGATCGATCAACTCATG
AATCGATCGATCAATATCG -> ATCGATCGATCAATATCGC
AATCGGCTTCGCGTATGAC -> ATCGGCTTCGCGTATGACT
AATCGTCGGGCGTTCTCGA -> ATCGTCGGGCGTTCTCGAG
AATCGTTGCCGGTACATCG -> ATCGTTGCCGGTACATCGA
AATCTGAACACGTAAATTA -> ATCTGAACACGTAAATTAA
AATCTTCAGCTAGAATGCT -> ATCTTCAGCTAGAATGCTA
AATGACGTAGGGAACCTCC -> ATGACGTAGGGAACCTCCA
AATGCTACAATGCTTGCAA -> ATGCTACAATGCTTGCAAA
AATGCTTGCAAACTAGAGG -> ATGCTTGCAAACTAGAGGG
AATGTGTGCTCGGGTTACT -> ATGTGTGCTCGGGTTACTA
AATTAAGAGTAGTTTTCTT -> ATTAAGAGTAGTTTTCTTT
AATTAAGTAGACTGCTGAC -> ATTAAGTAGACTGCTGACA
AATTAATTGTACGCTACGT -> ATTAATTGTACGCTACGTA
AATTATCTGATTGGTTAGC -> ATTATCTGATTGGTTAGCG
AATTCCAAGTGACGACTAA -> ATTCCAAGTGACGACTAAT
AATTCTTCTATCGCAGAAT -> ATTCTTCTATCGCAGAATT
AATTGACCTCAACGAGAAG -> ATTGACCTCAACGAGAAGA
AATTGAGCCCTAGTATTTC -> ATTGAGCCCTAGTATTTCA
AATTGCCCTGGGCTTCAAC -> ATTGCCCTGGGCTTCAACC
AATTGTACGCTACGTACGA -> ATTGTACGCTACGTACGAA
AATTTAGTCAGTGTTGTGT -> ATTTAGTCAGTGTTGTGTC
AATTTCGTGGAACGGGCAG -> ATTTCGTGGAACGGGCAGT
AATTTGCCTAGTTCACTGA -> ATTTGCCTAGTTCACTGAA
ACAAAACCGCGCGAAAATC -> CAAAACCGCGCGAAAATCG
ACAAAATCCCGAGGAGCCG -> CAAAATCCCGAGGAGCCGC
ACAAACTATTGAAATCTTC -> CAAACTATTGAAATCTTCA
ACAAAGTCTTCCGCTTCAA -> CAAAGTCTTCCGCTTCAAT
ACAAGATATCAGATGGAGA -> CAAGATATCAGATGGAGAC
ACAAGATGTTCGGCAGGAG -> CAAGATGTTCGGCAGGAGC
ACAAGCGAATTCCAAGTGA -> CAAGCGAATTCCAAGTGAC
ACAATCGACCAAGCTTTGC -> CAATCGACCAAGCTTTGCG
ACAATGCTTGCAAACTAGA -> CAATGCTTGCAAACTAGAG
ACAATTAAGAGTAGTTTTC -> CAATTAAGAGTAGTTTTCT
ACACATCGGAAAGGAAGTG -> CACATCGGAAAGGAAGTGT
ACACCACTATTCCAAAACC -> CACCACTATTCCAAAACCT
ACACCACTCCAGTAACGCC -> CACCACTCCAGTAACGCCT
ACACCACTGCAACTTGGGT -> CACCACTGCAACTTGGGTT
ACACCACTTCCGCTCCAGG -> CACCACTTCCGCTCCAGGT
ACACCTTTACCAGCAGCAC -> CACCTTTACCAGCAGCACG
ACACGGCTGTGCTATACTG -> CACGGCTGTGCTATACTGG
ACACGTAAATTAATTGTAC -> CACGTAAATTAATTGTACG
ACACGTACGCGCCGACCTA -> CACGTACGCGCCGACCTAC
ACACTCATTTCTCAGACAC -> CACTCATTTCTCAGACACG
ACACTCGTCGTTGCCGTTC -> CACTCGTCGTTGCCGTTCT
ACAGAAGGGGCTCCTCGGT -> CAGAAGGGGCTCCTCGGTT
ACAGATGATGATTGTTACC -> CAGATGATGATTGTTACCG
ACAGCAACCTGTAGCGGCG -> CAGCAACCTGTAGCGGCGC
ACAGCCAGTCTCCCCTTGG -> CAGCCAGTCTCCCCTTGGA
ACATACCCCTTTCCCTAAC -> CATACCCCTTTCCCTAACG
ACATATATAACGGCATAGG -> CATATATAACGGCATAGGG
ACATCGAATATTCATAAGT -> CATCGAATATTCATAAGTC
ACATCGGAAAGGAAGTGTA -> CATCGGAAAGGAAGTGTAC
ACATCTTGCATAAAATTGC -> CATCTTGCATAAAATTGCC
ACATGATCATCGGACACTC -> CATGATCATCGGACACTCG
ACATGCTAGTGCTTGGCAG -> CATGCTAGTGCTTGGCAGT
ACATGTTTTTATTTACACT -> CATGTTTTTATTTACACTC
ACATTCACCTACATATATA -> CATTCACCTACATATATAA
ACCAACAAAACCGCGCGAA -> CCAACAAAACCGCGCGAAA
ACCACGAGCTCTGCATACA -> CCACGAGCTCTGCATACAT
ACCACTATTCCAAAACCTA -> CCACTATTCCAAAACCTAC
ACCACTCCAGTAACGCCTA -> CCACTCCAGTAACGCCTAC
ACCACTGCAACTTGGGTTA -> CCACTGCAACTTGGGTTAC
ACCACTTCCGCTCCAGGTA -> CCACTTCCGCTCCAGGTAC
ACCAGCAGCACGTCTCAAG -> CCAGCAGCACGTCTCAAGG
ACCAGGCTCTTGTCTTCAC -> CCAGGCTCTTGTCTTCACC
ACCAGGTAACCGAGCACCT -> CCAGGTAACCGAGCACCTA
ACCCACAAACTATTGAAAT -> CCCACAAACTATTGAAATC
ACCCCTTGGTGTTTTAGTT -> CCCCTTGGTGTTTTAGTTA
ACCCCTTTCCCTAACGTAC -> CCCCTTTCCCTAACGTACT
ACCCGATCTATGGCGTTCA -> CCCGATCTATGGCGTTCAT
ACCCTCAGTTGACGTAACC -> CCCTCAGTTGACGTAACCT
ACCCTGTCTGCAGCGTATG -> CCCTGTCTGCAGCGTATGG
ACCCTTCATACACGTACGC -> CCCTTCATACACGTACGCG
ACCGAAACCAGGCTCTTGT -> CCGAAACCAGGCTCTTGTC
ACCGAGCACCTACGTTGAT -> CCGAGCACCTACGTTGATC
ACCGCGCGAAAATCGGCTT -> CCGCGCGAAAATCGGCTTC
ACCGGCAGTCACATGCTAG -> CCGGCAGTCACATGCTAGT
ACCGGCTACTCGGTTCGTC -> CCGGCTACTCGGTTCGTCA
ACCGTACGTCTTAAGACAG -> CCGTACGTCTTAAGACAGC
ACCTACATATATAACGGCA -> CCTACATATATAACGGCAT
ACCTACCTTACTTCCCGCG -> CCTACCTTACTTCCCGCGT
ACCTACGTTGATCGTAAGC -> CCTACGTTGATCGTAAGCT
ACCTACTGAATCGATCGAT -> CCTACTGAATCGATCGATC
ACCTAGACTGCTGACACCA -> CCTAGACTGCTGACACCAC
ACCTCAACGAGAAGAGGTG -> CCTCAACGAGAAGAGGTGT
ACCTCCATATCTTTAAGAT -> CCTCCATATCTTTAAGATA
ACCTCCTGTAAGACATGAT -> CCTCCTGTAAGACATGATC
ACCTGCCTGCGGGTGGCTA -> CCTGCCTGCGGGTGGCTAA
ACCTGTAGCGGCGCCCTGG -> CCTGTAGCGGCGCCCTGGC
ACCTTACTTCCCGCGTGTC -> CCTTACTTCCCGCGTGTCA
ACCTTTACCAGCAGCACGT -> CCTTTACCAGCAGCACGTC
ACGAAATGTGTGCTCGGGT -> CGAAATGTGTGCTCGGGTT
ACGACTAATTAAGTAGACT -> CGACTAATTAAGTAGACTG
ACGACTTCACAAGCGAATT -> CGACTTCACAAGCGAATTC
ACGAGAAGAGGTGTGTAAA -> CGAGAAGAGGTGTGTAAAC
ACGAGCTCTGCATACATGT -> CGAGCTCTGCATACATGTT
ACGATCACAAAGTCTTCCG -> CGATCACAAAGTCTTCCGC
ACGCAGTTCCGGCACTTCC -> CGCAGTTCCGGCACTTCCC
ACGCCTACTGAATCGATCG -> CGCCTACTGAATCGATCGA
ACGCCTCGACGTATCGATA -> CGCCTCGACGTATCGATAA
ACGCGCCGACCTACCTTAC -> CGCGCCGACCTACCTTACT
ACGCGTTGCTATGACTGTG -> CGCGTTGCTATGACTGTGA
ACGCTACGTACGAAATGTG -> CGCTACGTACGAAATGTGT
ACGCTCAATGACGTAGGGA -> CGCTCAATGACGTAGGGAA
ACGGACAAGATATCAGATG -> CGGACAAGATATCAGATGG
ACGGATATAAAATCCGGAT -> CGGATATAAAATCCGGATA
ACGGCATAGGGGCATTCGC -> CGGCATAGGGGCATTCGCC
ACGGCTGTGCTATACTGGA -> CGGCTGTGCTATACTGGAT
ACGGGCAGTCAATTTAGTC -> CGGGCAGTCAATTTAGTCA
ACGTAAATTAATTGTACGC -> CGTAAATTAATTGTACGCT
ACGTAACCTCCTGTAAGAC -> CGTAACCTCCTGTAAGACA
ACGTACGAAATGTGTGCTC -> CGTACGAAATGTGTGCTCG
ACGTACGCGCCGACCTACC -> CGTACGCGCCGACCTACCT
ACGTACTTAGAACAATTAA -> CGTACTTAGAACAATTAAG
ACGTAGGGAACCTCCATAT -> CGTAGGGAACCTCCATATC
ACGTAGGGAGAAAAAAATC -> CGTAGGGAGAAAAAAATCT
ACGTATCGATAACAGAAGG -> CGTATCGATAACAGAAGGG
ACGTCTCAAGGTCAAGACT -> CGTCTCAAGGTCAAGACTG
ACGTCTTAAGACAGCAACC -> CGTCTTAAGACAGCAACCT
ACGTGACGCGTTGCTATGA -> CGTGACGCGTTGCTATGAC
ACGTGCGCGAGGTAGTTGT -> CGTGCGCGAGGTAGTTGTG
ACGTTGATCGTAAGCTCAT -> CGTTGATCGTAAGCTCATA
ACTAAACCGTACGTCTTAA -> CTAAACCGTACGTCTTAAG
ACTAACTAAACCGTACGTC -> CTAACTAAACCGTACGTCT
ACTAATTAAGTAGACTGCT -> CTAATTAAGTAGACTGCTG
ACTAGAGGGCCTTCTTATC -> CTAGAGGGCCTTCTTATCC
ACTATAATCGTCGGGCGTT -> CTATAATCGTCGGGCGTTC
ACTATCTGATGTTAAAACT -> CTATCTGATGTTAAAACTG
ACTATTCCAAAACCTACTG -> CTATTCCAAAACCTACTGA
ACTATTGAAATCTTCAGCT -> CTATTGAAATCTTCAGCTA
ACTCATAAGCATCCTCTGA -> CTCATAAGCATCCTCTGAT
ACTCATGAGAAGTCTGTGT -> CTCATGAGAAGTCTGTGTA
ACTCATTTCTCAGACACGG -> CTCATTTCTCAGACACGGC
ACTCCAGTAACGCCTACTG -> CTCCAGTAACGCCTACTGA
ACTCCATTCGTTTATTAGA -> CTCCATTCGTTTATTAGAG
ACTCCTGAGCCTTACGCCT -> CTCCTGAGCCTTACGCCTC
ACTCGGTTCGTCAGTTCCT -> CTCGGTTCGTCAGTTCCTT
ACTCGTCGTTGCCGTTCTA -> CTCGTCGTTGCCGTTCTAC
ACTCTTTAGACTGCTGACA -> CTCTTTAGACTGCTGACAC
ACTGAAGACCAACAAAACC -> CTGAAGACCAACAAAACCG
ACTGAATCGATCGATCAAA -> CTGAATCGATCGATCAAAT
ACTGAATCGATCGATCAAC -> CTGAATCGATCGATCAACC,CTGAATCGATCGATCAACT
ACTGAATCGATCGATCAAT -> CTGAATCGATCGATCAATA
ACTGACAGATGATGATTGT -> CTGACAGATGATGATTGTT
ACTGACGATCACAAAGTCT -> CTGACGATCACAAAGTCTT
ACTGATTAGAAGCCGGCAC -> CTGATTAGAAGCCGGCACA
ACTGCAACTTGGGTTACTG -> CTGCAACTTGGGTTACTGA
ACTGCGAGTAGTTTATGCC -> CTGCGAGTAGTTTATGCCG
ACTGCTGACACCACTATTC -> CTGCTGACACCACTATTCC
ACTGCTGACACCACTCCAG -> CTGCTGACACCACTCCAGT
ACTGCTGACACCACTGCAA -> CTGCTGACACCACTGCAAC
ACTGCTGACACCACTTCCG -> CTGCTGACACCACTTCCGC
ACTGGATCGTTTTGCCGCG -> CTGGATCGTTTTGCCGCGC
ACTGGCATTGCCATGTCAC -> CTGGCATTGCCATGTCACA
ACTGGCGCCGCACGGACAA -> CTGGCGCCGCACGGACAAG
ACTGGTTTAATAACGGATA -> CTGGTTTAATAACGGATAT
ACTGTATAGCGATAACTCC -> CTGTATAGCGATAACTCCA
ACTGTGAAGCAGGTTATCT -> CTGTGAAGCAGGTTATCTG
ACTTAGAACAATTAAGAGT -> CTTAGAACAATTAAGAGTA
ACTTCAATTTCGTGGAACG -> CTTCAATTTCGTGGAACGG
ACTTCACAAGCGAATTCCA -> CTTCACAAGCGAATTCCAA
ACTTCCCCCTGAGGACTGG -> CTTCCCCCTGAGGACTGGT
ACTTCCCGCGTGTCAGATG -> CTTCCCGCGTGTCAGATGG
ACTTCCGAACAATCGACCA -> CTTCCGAACAATCGACCAA
ACTTCCGCTCCAGGTACTG -> CTTCCGCTCCAGGTACTGA
ACTTGGGTTACTGAATCGA -> CTTGGGTTACTGAATCGAT
ACTTTTTGTGATGCGAGAA -> CTTTTTGTGATGCGAGAAC
AGAAAAAAATCTGAACACG -> GAAAAAAATCTGAACACGT
AGAAAGCAATCCTTAGAGG -> GAAAGCAATCCTTAGAGGC
AGAAAGTATATCTTAGGAT -> GAAAGTATATCTTAGGATG
AGAACAAGATGTTCGGCAG -> GAACAAGATGTTCGGCAGG
AGAACAATTAAGAGTAGTT -> GAACAATTAAGAGTAGTTT
AGAACTGGCATTGCCATGT -> GAACTGGCATTGCCATGTC
AGAAGAGGTGTGTAAACCC -> GAAGAGGTGTGTAAACCCT
AGAAGCCGGCACATCTTGC -> GAAGCCGGCACATCTTGCA
AGAAGGGGCTCCTCGGTTA -> GAAGGGGCTCCTCGGTTAG
AGAAGTCTGTGTACTCCTG -> GAAGTCTGTGTACTCCTGA
AGAATCGTTGCCGGTACAT -> GAATCGTTGCCGGTACATC
AGAATGCTACAATGCTTGC -> GAATGCTACAATGCTTGCA
AGAATTGACCTCAACGAGA -> GAATTGACCTCAACGAGAA
AGACACGGCTGTGCTATAC -> GACACGGCTGTGCTATACT
AGACAGCAACCTGTAGCGG -> GACAGCAACCTGTAGCGGC
AGACATGATCATCGGACAC -> GACATGATCATCGGACACT
AGACCAACAAAACCGCGCG -> GACCAACAAAACCGCGCGA
AGACCCTTCATACACGTAC -> GACCCTTCATACACGTACG
AGACTCATAAGCATCCTCT -> GACTCATAAGCATCCTCTG
AGACTCTTTAGACTGCTGA -> GACTCTTTAGACTGCTGAC
AGACTGCTGACACCACTAT -> GACTGCTGACACCACTATT
AGACTGCTGACACCACTCC -> GACTGCTGACACCACTCCA
AGACTGCTGACACCACTGC -> GACTGCTGACACCACTGCA
AGACTGCTGACACCACTTC -> GACTGCTGACACCACTTCC
AGACTGGCGCCGCACGGAC -> GACTGGCGCCGCACGGACA
AGACTGTATAGCGATAACT -> GACTGTATAGCGATAACTC
AGAGAATCGTTGCCGGTAC -> GAGAATCGTTGCCGGTACA
AGAGCTTTCCCACAAAATC -> GAGCTTTCCCACAAAATCC
AGAGGCTGACCCTCAGTTG -> GAGGCTGACCCTCAGTTGA
AGAGGGCCTTCTTATCCTT -> GAGGGCCTTCTTATCCTTG
AGAGGTGTGTAAACCCTGT -> GAGGTGTGTAAACCCTGTC
AGAGTAGTTTTCTTTTCAA -> GAGTAGTTTTCTTTTCAAC
AGATAATTGAGCCCTAGTA -> GATAATTGAGCCCTAGTAT
AGATAGAAAGTATATCTTA -> GATAGAAAGTATATCTTAG
AGATATCAGATGGAGACTC -> GATATCAGATGGAGACTCA
AGATCAAAGAACTGGCATT -> GATCAAAGAACTGGCATTG
AGATGATGATTGTTACCGG -> GATGATGATTGTTACCGGC
AGATGGAGACTCATAAGCA -> GATGGAGACTCATAAGCAT
AGATGGTTGGCCCGTGGGG -> GATGGTTGGCCCGTGGGGC
AGATGTTCGGCAGGAGCCA -> GATGTTCGGCAGGAGCCAT
AGATTCGGCTTCCAGATAG -> GATTCGGCTTCCAGATAGA
AGCAACCTGTAGCGGCGCC -> GCAACCTGTAGCGGCGCCC
AGCAATCCTTAGAGGCTGA -> GCAATCCTTAGAGGCTGAC
AGCACCTACGTTGATCGTA -> GCACCTACGTTGATCGTAA
AGCACGTCTCAAGGTCAAG -> GCACGTCTCAAGGTCAAGA
AGCAGCACGTCTCAAGGTC -> GCAGCACGTCTCAAGGTCA
AGCAGGTTATCTGGGGCGC -> GCAGGTTATCTGGGGCGCG
AGCATCCTCTGATCCTGGC -> GCATCCTCTGATCCTGGCC
AGCCAGTCTCCCCTTGGAA -> GCCAGTCTCCCCTTGGAAG
AGCCATCTGATATTTACGT -> GCCATCTGATATTTACGTG
AGCCCTAGTATTTCATTCG -> GCCCTAGTATTTCATTCGC
AGCCGCGCCAGACTCTTTA -> GCCGCGCCAGACTCTTTAG
AGCCGGCACATCTTGCATA -> GCCGGCACATCTTGCATAA
AGCCTTACGCCTCGACGTA -> GCCTTACGCCTCGACGTAT
AGCGAATTCCAAGTGACGA -> GCGAATTCCAAGTGACGAC
AGCGAGGGCACTGACAGAT -> GCGAGGGCACTGACAGATG
AGCGATAACTCCATTCGTT -> GCGATAACTCCATTCGTTT
AGCGATTCACAGCCAGTCT -> GCGATTCACAGCCAGTCTC
AGCGCCAGTCCACTAACTA -> GCGCCAGTCCACTAACTAA
AGCGGCGCCCTGGCTGCGA -> GCGGCGCCCTGGCTGCGAC
AGCGGTGACACATCGGAAA -> GCGGTGACACATCGGAAAG
AGCGTATGGGGATTGCAGT -> GCGTATGGGGATTGCAGTG
AGCGTGGGCACCAGGTAAC -> GCGTGGGCACCAGGTAACC
AGCTAGAATGCTACAATGC -> GCTAGAATGCTACAATGCT
AGCTCATAGATTCGGCTTC -> GCTCATAGATTCGGCTTCC
AGCTCCACTATAATCGTCG -> GCTCCACTATAATCGTCGG
AGCTCGGAAGTTATCTGAT -> GCTCGGAAGTTATCTGATT
AGCTCTGCATACATGTTTT -> GCTCTGCATACATGTTTTT
AGCTGGTATGATCCATGAC -> GCTGGTATGATCCATGACA
AGCTTCTTTTCGATTCGGA -> GCTTCTTTTCGATTCGGAT
AGCTTTCCCACAAAATCCC -> GCTTTCCCACAAAATCCCG
AGGAAGTGTACGTGACGCG -> GGAAGTGTACGTGACGCGT
AGGACTGGTTTAATAACGG -> GGACTGGTTTAATAACGGA
AGGAGCCATCTGATATTTA -> GGAGCCATCTGATATTTAC
AGGAGCCGCGCCAGACTCT -> GGAGCCGCGCCAGACTCTT
AGGAGCTGGTATGATCCAT -> GGAGCTGGTATGATCCATG
AGGATGTCAGCTCCACTAT -> GGATGTCAGCTCCACTATA
AGGCAAGCGAGGGCACTGA -> GGCAAGCGAGGGCACTGAC
AGGCCCACTTCAATTTCGT -> GGCCCACTTCAATTTCGTG
AGGCGAGAGAATCGTTGCC -> GGCGAGAGAATCGTTGCCG
AGGCGGTCACTGACGATCA -> GGCGGTCACTGACGATCAC
AGGCTCTTGTCTTCACCGG -> GGCTCTTGTCTTCACCGGC
AGGCTGACCCTCAGTTGAC -> GGCTGACCCTCAGTTGACG
AGGGAACCTCCATATCTTT -> GGGAACCTCCATATCTTTA
AGGGAGAAAAAAATCTGAA -> GGGAGAAAAAAATCTGAAC
AGGGCACTGACAGATGATG -> GGGCACTGACAGATGATGA
AGGGCCTTCTTATCCTTGG -> GGGCCTTCTTATCCTTGGA
AGGGGCATTCGCCTACCCG -> GGGGCATTCGCCTACCCGA
AGGGGCTCCTCGGTTAGCT -> GGGGCTCCTCGGTTAGCTT
AGGTAACCGAGCACCTACG -> GGTAACCGAGCACCTACGT
AGGTACTGAATCGATCGAT -> GGTACTGAATCGATCGATC
AGGTAGAAAGCAATCCTTA -> GGTAGAAAGCAATCCTTAG
AGGTAGGAGCTGGTATGAT -> GGTAGGAGCTGGTATGATC
AGGTAGTTGTGTTGATAAA -> GGTAGTTGTGTTGATAAAG
AGGTCAAGACTGTATAGCG -> GGTCAAGACTGTATAGCGA
AGGTCAGCTCGGAAGTTAT -> GGTCAGCTCGGAAGTTATC
AGGTGCATCGGCTACGACT -> GGTGCATCGGCTACGACTT
AGGTGTGTAAACCCTGTCT -> GGTGTGTAAACCCTGTCTG
AGGTTATCTGGGGCGCGAG -> GGTTATCTGGGGCGCGAGG
AGTAACGCCTACTGAATCG -> GTAACGCCTACTGAATCGA
AGTAAGACTGGCGCCGCAC -> GTAAGACTGGCGCCGCACG
AGTAGACTGCTGACACCAC -> GTAGACTGCTGACACCACT
AGTAGTTTATGCCGGTATG -> GTAGTTTATGCCGGTATGC
AGTAGTTTTCTTTTCAACC -> GTAGTTTTCTTTTCAACCG
AGTATATCTTAGGATGTCA -> GTATATCTTAGGATGTCAG
AGTATTGCGCGGACGCTCA -> GTATTGCGCGGACGCTCAA
AGTATTTCATTCGCACTTC -> GTATTTCATTCGCACTTCC
AGTCAATTTAGTCAGTGTT -> GTCAATTTAGTCAGTGTTG
AGTCACATGCTAGTGCTTG -> GTCACATGCTAGTGCTTGG
AGTCAGTGTTGTGTCAGGC -> GTCAGTGTTGTGTCAGGCG
AGTCCACTAACTAAACCGT -> GTCCACTAACTAAACCGTA
AGTCGCTCCTGGTAGCGCC -> GTCGCTCCTGGTAGCGCCA
AGTCTCCCCTTGGAAGACC -> GTCTCCCCTTGGAAGACCC
AGTCTGTGTACTCCTGAGC -> GTCTGTGTACTCCTGAGCC
AGTCTTCCGCTTCAATTTG -> GTCTTCCGCTTCAATTTGC
AGTGACGACTAATTAAGTA -> GTGACGACTAATTAAGTAG
AGTGCTTGGCAGTATTGCG -> GTGCTTGGCAGTATTGCGC
AGTGTACGTGACGCGTTGC -> GTGTACGTGACGCGTTGCT
AGTGTCGCTTTTTGGTGAG -> GTGTCGCTTTTTGGTGAGC
AGTGTTGTGTCAGGCGAGA -> GTGTTGTGTCAGGCGAGAG
AGTTACTTTTTGTGATGCG -> GTTACTTTTTGTGATGCGA
AGTTATCTGATTAATATGC -> GTTATCTGATTAATATGCA
AGTTCACTGAAGACCAACA -> GTTCACTGAAGACCAACAA
AGTTCCGGCACTTCCCCCT -> GTTCCGGCACTTCCCCCTG
AGTTCCTTATGGCTGAGCG -> GTTCCTTATGGCTGAGCGA
AGTTGACGTAACCTCCTGT -> GTTGACGTAACCTCCTGTA
AGTTGTGTTGATAAAGATC -> GTTGTGTTGATAAAGATCA
AGTTTAGGTAGGAGCTGGT -> GTTTAGGTAGGAGCTGGTA
AGTTTATGCCGGTATGCCT -> GTTTATGCCGGTATGCCTA
AGTTTTCTTTTCAACCGAA -> GTTTTCTTTTCAACCGAAA
ATAAAATCCGGATAGGCCC -> TAAAATCCGGATAGGCCCA
ATAAAATTGCCCTGGGCTT -> TAAAATTGCCCTGGGCTTC
ATAAAGATCAAAGAACTGG -> TAAAGATCAAAGAACTGGC
ATAACAGAAGGGGCTCCTC -> TAACAGAAGGGGCTCCTCG
ATAACGGATATAAAATCCG -> TAACGGATATAAAATCCGG
ATAACGGCATAGGGGCATT -> TAACGGCATAGGGGCATTC
ATAACTCCATTCGTTTATT -> TAACTCCATTCGTTTATTA
ATAAGCATCCTCTGATCCT -> TAAGCATCCTCTGATCCTG
ATAAGTCGCTCCTGGTAGC -> TAAGTCGCTCCTGGTAGCG
ATAATCGTCGGGCGTTCTC -> TAATCGTCGGGCGTTCTCG
ATAATTGAGCCCTAGTATT -> TAATTGAGCCCTAGTATTT
ATACACGTACGCGCCGACC -> TACACGTACGCGCCGACCT
ATACATGTTTTTATTTACA -> TACATGTTTTTATTTACAC
ATACCCCTTTCCCTAACGT -> TACCCCTTTCCCTAACGTA
ATACTGGATCGTTTTGCCG -> TACTGGATCGTTTTGCCGC
ATAGAAAGTATATCTTAGG -> TAGAAAGTATATCTTAGGA
ATAGACTGCTGACACCACT -> TAGACTGCTGACACCACTA
ATAGATTCGGCTTCCAGAT -> TAGATTCGGCTTCCAGATA
ATAGCGATAACTCCATTCG -> TAGCGATAACTCCATTCGT
ATAGGCCCACTTCAATTTC -> TAGGCCCACTTCAATTTCG
ATAGGGGCATTCGCCTACC -> TAGGGGCATTCGCCTACCC
ATAGGTAGAAAGCAATCCT -> TAGGTAGAAAGCAATCCTT
ATATAAAATCCGGATAGGC -> TATAAAATCCGGATAGGCC
ATATAACGGCATAGGGGCA -> TATAACGGCATAGGGGCAT
ATATATAACGGCATAGGGG -> TATATAACGGCATAGGGGC
ATATCAGATGGAGACTCAT -> TATCAGATGGAGACTCATA
ATATCGCTGTCAATTCTTC -> TATCGCTGTCAATTCTTCT
ATATCGGGCTCGTACCTGC -> TATCGGGCTCGTACCTGCC
ATATCTTAGGATGTCAGCT -> TATCTTAGGATGTCAGCTC
ATATCTTTAAGATAATTGA -> TATCTTTAAGATAATTGAG
ATATGCAGGTGCATCGGCT -> TATGCAGGTGCATCGGCTA
ATATTCATAAGTCGCTCCT -> TATTCATAAGTCGCTCCTG
ATATTTACGTGCGCGAGGT -> TATTTACGTGCGCGAGGTA
ATCAAAGAACTGGCATTGC -> TCAAAGAACTGGCATTGCC
ATCAAATTATCTGATTGGT -> TCAAATTATCTGATTGGTT
ATCAACCCACAAACTATTG -> TCAACCCACAAACTATTGA
ATCAACTCATGAGAAGTCT -> TCAACTCATGAGAAGTCTG
ATCAATATCGCTGTCAATT -> TCAATATCGCTGTCAATTC
ATCACAAAGTCTTCCGCTT -> TCACAAAGTCTTCCGCTTC
ATCAGATGGAGACTCATAA -> TCAGATGGAGACTCATAAG
ATCATCGGACACTCGTCGT -> TCATCGGACACTCGTCGTT
ATCCATGACATACCCCTTT -> TCCATGACATACCCCTTTC
ATCCCGAGGAGCCGCGCCA -> TCCCGAGGAGCCGCGCCAG
ATCCGGATAGGCCCACTTC -> TCCGGATAGGCCCACTTCA
ATCCTCTGATCCTGGCCGA -> TCCTCTGATCCTGGCCGAC
ATCCTGGCCGACACCTTTA -> TCCTGGCCGACACCTTTAC
ATCCTTAGAGGCTGACCCT -> TCCTTAGAGGCTGACCCTC
ATCCTTGGAGGCAAGCGAG -> TCCTTGGAGGCAAGCGAGG
ATCGAATATTCATAAGTCG -> TCGAATATTCATAAGTCGC
ATCGATAACAGAAGGGGCT -> TCGATAACAGAAGGGGCTC
ATCGATCAAATTATCTGAT -> TCGATCAAATTATCTGATT
ATCGATCAACCCACAAACT -> TCGATCAACCCACAAACTA
ATCGATCAACTCATGAGAA -> TCGATCAACTCATGAGAAG
ATCGATCAATATCGCTGTC -> TCGATCAATATCGCTGTCA
ATCGATCGATCAAATTATC -> TCGATCGATCAAATTATCT
ATCGATCGATCAACCCACA -> TCGATCGATCAACCCACAA
ATCGATCGATCAACTCATG -> TCGATCGATCAACTCATGA
ATCGATCGATCAATATCGC -> TCGATCGATCAATATCGCT
ATCGCAGAATTGACCTCAA -> TCGCAGAATTGACCTCAAC
ATCGCTGTCAATTCTTCTA -> TCGCTGTCAATTCTTCTAT
ATCGGAAAGGAAGTGTACG -> TCGGAAAGGAAGTGTACGT
ATCGGACACTCGTCGTTGC -> TCGGACACTCGTCGTTGCC
ATCGGCTACGACTTCACAA -> TCGGCTACGACTTCACAAG
ATCGGCTTCGCGTATGACT -> TCGGCTTCGCGTATGACTG
ATCGGGCTCGTACCTGCCT -> TCGGGCTCGTACCTGCCTG
ATCGTAAGCTCATAGATTC -> TCGTAAGCTCATAGATTCG
ATCGTCGGGCGTTCTCGAG -> TCGTCGGGCGTTCTCGAGG
ATCGTTGCCGGTACATCGA -> TCGTTGCCGGTACATCGAA
ATCGTTTTGCCGCGCTTTT -> TCGTTTTGCCGCGCTTTTT
ATCTATGGCGTTCATGCTT -> TCTATGGCGTTCATGCTTC
ATCTGAACACGTAAATTAA -> TCTGAACACGTAAATTAAT
ATCTGATATTTACGTGCGC -> TCTGATATTTACGTGCGCG
ATCTGATGTTAAAACTGCG -> TCTGATGTTAAAACTGCGA
ATCTGATTAATATGCAGGT -> TCTGATTAATATGCAGGTG
ATCTGATTGGTTAGCGGTG -> TCTGATTGGTTAGCGGTGA
ATCTGGGGCGCGAGGTCAG -> TCTGGGGCGCGAGGTCAGC
ATCTTAGGATGTCAGCTCC -> TCTTAGGATGTCAGCTCCA
ATCTTCAGCTAGAATGCTA -> TCTTCAGCTAGAATGCTAC
ATCTTGCATAAAATTGCCC -> TCTTGCATAAAATTGCCCT
ATCTTTAAGATAATTGAGC -> TCTTTAAGATAATTGAGCC
ATGACATACCCCTTTCCCT -> TGACATACCCCTTTCCCTA
ATGACGTAGGGAACCTCCA -> TGACGTAGGGAACCTCCAT
ATGACTGATTAGAAGCCGG -> TGACTGATTAGAAGCCGGC
ATGACTGTGAAGCAGGTTA -> TGACTGTGAAGCAGGTTAT
ATGAGAAGTCTGTGTACTC -> TGAGAAGTCTGTGTACTCC
ATGATCATCGGACACTCGT -> TGATCATCGGACACTCGTC
ATGATCCATGACATACCCC -> TGATCCATGACATACCCCT
ATGATGATTGTTACCGGCA -> TGATGATTGTTACCGGCAG
ATGATTGTTACCGGCAGTC -> TGATTGTTACCGGCAGTCA
ATGCAGGTGCATCGGCTAC -> TGCAGGTGCATCGGCTACG
ATGCCGGTATGCCTAGTAA -> TGCCGGTATGCCTAGTAAG
ATGCCTAGTAAGACTGGCG -> TGCCTAGTAAGACTGGCGC
ATGCGAGAACAAGATGTTC -> TGCGAGAACAAGATGTTCG
ATGCTACAATGCTTGCAAA -> TGCTACAATGCTTGCAAAC
ATGCTAGTGCTTGGCAGTA -> TGCTAGTGCTTGGCAGTAT
ATGCTTCACCACGAGCTCT -> TGCTTCACCACGAGCTCTG
ATGCTTGCAAACTAGAGGG -> TGCTTGCAAACTAGAGGGC
ATGGAGACTCATAAGCATC -> TGGAGACTCATAAGCATCC
ATGGCGTTCATGCTTCACC -> TGGCGTTCATGCTTCACCA
ATGGCTGAGCGATTCACAG -> TGGCTGAGCGATTCACAGC
ATGGGGATTGCAGTGTCGC -> TGGGGATTGCAGTGTCGCT
ATGGTTGGCCCGTGGGGCG -> TGGTTGGCCCGTGGGGCGC
ATGTCACATTCACCTACAT -> TGTCACATTCACCTACATA
ATGTCAGCTCCACTATAAT -> TGTCAGCTCCACTATAATC
ATGTGTGCTCGGGTTACTA -> TGTGTGCTCGGGTTACTAT
ATGTTAAAACTGCGAGTAG -> TGTTAAAACTGCGAGTAGT
ATGTTCGGCAGGAGCCATC -> TGTTCGGCAGGAGCCATCT
ATGTTTTTATTTACACTCA -> TGTTTTTATTTACACTCAT
ATTAAGAGTAGTTTTCTTT -> TTAAGAGTAGTTTTCTTTT
ATTAAGTAGACTGCTGACA -> TTAAGTAGACTGCTGACAC
ATTAATATGCAGGTGCATC -> TTAATATGCAGGTGCATCG
ATTAATTGTACGCTACGTA -> TTAATTGTACGCTACGTAC
ATTAGAAGCCGGCACATCT -> TTAGAAGCCGGCACATCTT
ATTAGAGCTTTCCCACAAA -> TTAGAGCTTTCCCACAAAA
ATTATCTGATTGGTTAGCG -> TTATCTGATTGGTTAGCGG
ATTCACAGCCAGTCTCCCC -> TTCACAGCCAGTCTCCCCT
ATTCACCTACATATATAAC -> TTCACCTACATATATAACG
ATTCATAAGTCGCTCCTGG -> TTCATAAGTCGCTCCTGGT
ATTCCAAAACCTACTGAAT -> TTCCAAAACCTACTGAATC
ATTCCAAGTGACGACTAAT -> TTCCAAGTGACGACTAATT
ATTCGCACTTCCGAACAAT -> TTCGCACTTCCGAACAATC
ATTCGCCTACCCGATCTAT -> TTCGCCTACCCGATCTATG
ATTCGGATATCGGGCTCGT -> TTCGGATATCGGGCTCGTA
ATTCGGCTTCCAGATAGAA -> TTCGGCTTCCAGATAGAAA
ATTCGTTTATTAGAGCTTT -> TTCGTTTATTAGAGCTTTC
ATTCTTCTATCGCAGAATT -> TTCTTCTATCGCAGAATTG
ATTGAAATCTTCAGCTAGA -> TTGAAATCTTCAGCTAGAA
ATTGACCTCAACGAGAAGA -> TTGACCTCAACGAGAAGAG
ATTGAGCCCTAGTATTTCA -> TTGAGCCCTAGTATTTCAT
ATTGCAGTGTCGCTTTTTG -> TTGCAGTGTCGCTTTTTGG
ATTGCCATGTCACATTCAC -> TTGCCATGTCACATTCACC
ATTGCCCTGGGCTTCAACC -> TTGCCCTGGGCTTCAACCT
ATTGCGCGGACGCTCAATG -> TTGCGCGGACGCTCAATGA
ATTGGTTAGCGGTGACACA -> TTGGTTAGCGGTGACACAT
ATTGTACGCTACGTACGAA -> TTGTACGCTACGTACGAAA
ATTGTTACCGGCAGTCACA -> TTGTTACCGGCAGTCACAT
ATTTACACTCATTTCTCAG -> TTTACACTCATTTCTCAGA
ATTTACGTGCGCGAGGTAG -> TTTACGTGCGCGAGGTAGT
ATTTAGTCAGTGTTGTGTC -> TTTAGTCAGTGTTGTGTCA
ATTTCATTCGCACTTCCGA -> TTTCATTCGCACTTCCGAA
ATTTCGTGGAACGGGCAGT -> TTTCGTGGAACGGGCAGTC
ATTTCTCAGACACGGCTGT -> TTTCTCAGACACGGCTGTG
ATTTGCCTAGTTCACTGAA -> TTTGCCTAGTTCACTGAAG
CAAAACCGCGCGAAAATCG -> AAAACCGCGCGAAAATCGG
CAAAACCTACTGAATCGAT -> AAAACCTACTGAATCGATC
CAAAATCCCGAGGAGCCGC -> AAAATCCCGAGGAGCCGCG
CAAACTAGAGGGCCTTCTT -> AAACTAGAGGGCCTTCTTA
CAAACTATTGAAATCTTCA -> AAACTATTGAAATCTTCAG
CAAAGAACTGGCATTGCCA -> AAAGAACTGGCATTGCCAT
CAAAGTCTTCCGCTTCAAT -> AAAGTCTTCCGCTTCAATT
CAAATTATCTGATTGGTTA -> AAATTATCTGATTGGTTAG
CAACAAAACCGCGCGAAAA -> AACAAAACCGCGCGAAAAT
CAACCCACAAACTATTGAA -> AACCCACAAACTATTGAAA
CAACCGAAACCAGGCTCTT -> AACCGAAACCAGGCTCTTG
CAACCTAGACTGCTGACAC -> AACCTAGACTGCTGACACC
CAACCTGTAGCGGCGCCCT -> AACCTGTAGCGGCGCCCTG
CAACGAGAAGAGGTGTGTA -> AACGAGAAGAGGTGTGTAA
CAACTCATGAGAAGTCTGT -> AACTCATGAGAAGTCTGTG
CAACTTGGGTTACTGAATC -> AACTTGGGTTACTGAATCG
CAAGACTGTATAGCGATAA -> AAGACTGTATAGCGATAAC
CAAGATATCAGATGGAGAC -> AAGATATCAGATGGAGACT
CAAGATGTTCGGCAGGAGC -> AAGATGTTCGGCAGGAGCC
CAAGCGAATTCCAAGTGAC -> AAGCGAATTCCAAGTGACG
CAAGCGAGGGCACTGACAG -> AAGCGAGGGCACTGACAGA
CAAGGTCAAGACTGTATAG -> AAGGTCAAGACTGTATAGC
CAAGTGACGACTAATTAAG -> AAGTGACGACTAATTAAGT
CAATATCGCTGTCAATTCT -> AATATCGCTGTCAATTCTT
CAATCCTTAGAGGCTGACC -> AATCCTTAGAGGCTGACCC
CAATCGACCAAGCTTTGCG -> AATCGACCAAGCTTTGCGG
CAATGACGTAGGGAACCTC -> AATGACGTAGGGAACCTCC
CAATGCTTGCAAACTAGAG -> AATGCTTGCAAACTAGAGG
CAATTAAGAGTAGTTTTCT -> AATTAAGAGTAGTTTTCTT
CAATTCTTCTATCGCAGAA -> AATTCTTCTATCGCAGAAT
CAATTTAGTCAGTGTTGTG -> AATTTAGTCAGTGTTGTGT
CAATTTCGTGGAACGGGCA -> AATTTCGTGGAACGGGCAG
CAATTTGCCTAGTTCACTG -> AATTTGCCTAGTTCACTGA
CACAAAATCCCGAGGAGCC -> ACAAAATCCCGAGGAGCCG
CACAAACTATTGAAATCTT -> ACAAACTATTGAAATCTTC
CACAAAGTCTTCCGCTTCA -> ACAAAGTCTTCCGCTTCAA
CACAAGCGAATTCCAAGTG -> ACAAGCGAATTCCAAGTGA
CACAGCCAGTCTCCCCTTG -> ACAGCCAGTCTCCCCTTGG
CACATCGGAAAGGAAGTGT -> ACATCGGAAAGGAAGTGTA
CACATCTTGCATAAAATTG -> ACATCTTGCATAAAATTGC
CACATGCTAGTGCTTGGCA -> ACATGCTAGTGCTTGGCAG
CACATTCACCTACATATAT -> ACATTCACCTACATATATA
CACCACGAGCTCTGCATAC -> ACCACGAGCTCTGCATACA
CACCACTATTCCAAAACCT -> ACCACTATTCCAAAACCTA
CACCACTCCAGTAACGCCT -> ACCACTCCAGTAACGCCTA
CACCACTGCAACTTGGGTT -> ACCACTGCAACTTGGGTTA
CACCACTTCCGCTCCAGGT -> ACCACTTCCGCTCCAGGTA
CACCAGGTAACCGAGCACC -> ACCAGGTAACCGAGCACCT
CACCGGCTACTCGGTTCGT -> ACCGGCTACTCGGTTCGTC
CACCTACATATATAACGGC -> ACCTACATATATAACGGCA
CACCTACGTTGATCGTAAG -> ACCTACGTTGATCGTAAGC
CACCTTTACCAGCAGCACG -> ACCTTTACCAGCAGCACGT
CACGAGCTCTGCATACATG -> ACGAGCTCTGCATACATGT
CACGGACAAGATATCAGAT -> ACGGACAAGATATCAGATG
CACGGCTGTGCTATACTGG -> ACGGCTGTGCTATACTGGA
CACGTAAATTAATTGTACG -> ACGTAAATTAATTGTACGC
CACGTACGCGCCGACCTAC -> ACGTACGCGCCGACCTACC
CACGTCTCAAGGTCAAGAC -> ACGTCTCAAGGTCAAGACT
CACTAACTAAACCGTACGT -> ACTAACTAAACCGTACGTC
CACTATAATCGTCGGGCGT -> ACTATAATCGTCGGGCGTT
CACTATTCCAAAACCTACT -> ACTATTCCAAAACCTACTG
CACTCATTTCTCAGACACG -> ACTCATTTCTCAGACACGG
CACTCCAGTAACGCCTACT -> ACTCCAGTAACGCCTACTG
CACTCGTCGTTGCCGTTCT -> ACTCGTCGTTGCCGTTCTA
CACTGAAGACCAACAAAAC -> ACTGAAGACCAACAAAACC
CACTGACAGATGATGATTG -> ACTGACAGATGATGATTGT
CACTGACGATCACAAAGTC -> ACTGACGATCACAAAGTCT
CACTGCAACTTGGGTTACT -> ACTGCAACTTGGGTTACTG
CACTTCAATTTCGTGGAAC -> ACTTCAATTTCGTGGAACG
CACTTCCCCCTGAGGACTG -> ACTTCCCCCTGAGGACTGG
CACTTCCGAACAATCGACC -> ACTTCCGAACAATCGACCA
CACTTCCGCTCCAGGTACT -> ACTTCCGCTCCAGGTACTG
CAGAAGGGGCTCCTCGGTT -> AGAAGGGGCTCCTCGGTTA
CAGAATTGACCTCAACGAG -> AGAATTGACCTCAACGAGA
CAGACACGGCTGTGCTATA -> AGACACGGCTGTGCTATAC
CAGACTCTTTAGACTGCTG -> AGACTCTTTAGACTGCTGA
CAGATAGAAAGTATATCTT -> AGATAGAAAGTATATCTTA
CAGATGATGATTGTTACCG -> AGATGATGATTGTTACCGG
CAGATGGAGACTCATAAGC -> AGATGGAGACTCATAAGCA
CAGATGGTTGGCCCGTGGG -> AGATGGTTGGCCCGTGGGG
CAGCAACCTGTAGCGGCGC -> AGCAACCTGTAGCGGCGCC
CAGCACGTCTCAAGGTCAA -> AGCACGTCTCAAGGTCAAG
CAGCAGCACGTCTCAAGGT -> AGCAGCACGTCTCAAGGTC
CAGCCAGTCTCCCCTTGGA -> AGCCAGTCTCCCCTTGGAA
CAGCGTATGGGGATTGCAG -> AGCGTATGGGGATTGCAGT
CAGCTAGAATGCTACAATG -> AGCTAGAATGCTACAATGC
CAGCTCCACTATAATCGTC -> AGCTCCACTATAATCGTCG
CAGCTCGGAAGTTATCTGA -> AGCTCGGAAGTTATCTGAT
CAGGAGCCATCTGATATTT -> AGGAGCCATCTGATATTTA
CAGGCGAGAGAATCGTTGC -> AGGCGAGAGAATCGTTGCC
CAGGCTCTTGTCTTCACCG -> AGGCTCTTGTCTTCACCGG
CAGGTAACCGAGCACCTAC -> AGGTAACCGAGCACCTACG
CAGGTACTGAATCGATCGA -> AGGTACTGAATCGATCGAT
CAGGTGCATCGGCTACGAC -> AGGTGCATCGGCTACGACT
CAGGTTATCTGGGGCGCGA -> AGGTTATCTGGGGCGCGAG
CAGTAACGCCTACTGAATC -> AGTAACGCCTACTGAATCG
CAGTATTGCGCGGACGCTC -> AGTATTGCGCGGACGCTCA
CAGTCAATTTAGTCAGTGT -> AGTCAATTTAGTCAGTGTT
CAGTCACATGCTAGTGCTT -> AGTCACATGCTAGTGCTTG
CAGTCCACTAACTAAACCG -> AGTCCACTAACTAAACCGT
CAGTCTCCCCTTGGAAGAC -> AGTCTCCCCTTGGAAGACC
CAGTGTCGCTTTTTGGTGA -> AGTGTCGCTTTTTGGTGAG
CAGTGTTGTGTCAGGCGAG -> AGTGTTGTGTCAGGCGAGA
CAGTTCCGGCACTTCCCCC -> AGTTCCGGCACTTCCCCCT
CAGTTCCTTATGGCTGAGC -> AGTTCCTTATGGCTGAGCG
CAGTTGACGTAACCTCCTG -> AGTTGACGTAACCTCCTGT
CATAAAATTGCCCTGGGCT -> ATAAAATTGCCCTGGGCTT
CATAAGCATCCTCTGATCC -> ATAAGCATCCTCTGATCCT
CATAAGTCGCTCCTGGTAG -> ATAAGTCGCTCCTGGTAGC
CATACACGTACGCGCCGAC -> ATACACGTACGCGCCGACC
CATACATGTTTTTATTTAC -> ATACATGTTTTTATTTACA
CATACCCCTTTCCCTAACG -> ATACCCCTTTCCCTAACGT
CATAGACTGCTGACACCAC -> ATAGACTGCTGACACCACT
CATAGATTCGGCTTCCAGA -> ATAGATTCGGCTTCCAGAT
CATAGGGGCATTCGCCTAC -> ATAGGGGCATTCGCCTACC
CATATATAACGGCATAGGG -> ATATATAACGGCATAGGGG
CATATCTTTAAGATAATTG -> ATATCTTTAAGATAATTGA
CATCCTCTGATCCTGGCCG -> ATCCTCTGATCCTGGCCGA
CATCGAATATTCATAAGTC -> ATCGAATATTCATAAGTCG
CATCGGAAAGGAAGTGTAC -> ATCGGAAAGGAAGTGTACG
CATCGGACACTCGTCGTTG -> ATCGGACACTCGTCGTTGC
CATCGGCTACGACTTCACA -> ATCGGCTACGACTTCACAA
CATCTGATATTTACGTGCG -> ATCTGATATTTACGTGCGC
CATCTTGCATAAAATTGCC -> ATCTTGCATAAAATTGCCC
CATGACATACCCCTTTCCC -> ATGACATACCCCTTTCCCT
CATGAGAAGTCTGTGTACT -> ATGAGAAGTCTGTGTACTC
CATGATCATCGGACACTCG -> ATGATCATCGGACACTCGT
CATGCTAGTGCTTGGCAGT -> ATGCTAGTGCTTGGCAGTA
CATGCTTCACCACGAGCTC -> ATGCTTCACCACGAGCTCT
CATGTCACATTCACCTACA -> ATGTCACATTCACCTACAT
CATGTTTTTATTTACACTC -> ATGTTTTTATTTACACTCA
CATTCACCTACATATATAA -> ATTCACCTACATATATAAC
CATTCGCACTTCCGAACAA -> ATTCGCACTTCCGAACAAT
CATTCGCCTACCCGATCTA -> ATTCGCCTACCCGATCTAT
CATTCGTTTATTAGAGCTT -> ATTCGTTTATTAGAGCTTT
CATTGCCATGTCACATTCA -> ATTGCCATGTCACATTCAC
CATTTCTCAGACACGGCTG -> ATTTCTCAGACACGGCTGT
CCAAAACCTACTGAATCGA -> CAAAACCTACTGAATCGAT
CCAACAAAACCGCGCGAAA -> CAACAAAACCGCGCGAAAA
CCAAGTGACGACTAATTAA -> CAAGTGACGACTAATTAAG
CCACAAAATCCCGAGGAGC -> CACAAAATCCCGAGGAGCC
CCACAAACTATTGAAATCT -> CACAAACTATTGAAATCTT
CCACGAGCTCTGCATACAT -> CACGAGCTCTGCATACATG
CCACTAACTAAACCGTACG -> CACTAACTAAACCGTACGT
CCACTATAATCGTCGGGCG -> CACTATAATCGTCGGGCGT
CCACTATTCCAAAACCTAC -> CACTATTCCAAAACCTACT
CCACTCCAGTAACGCCTAC -> CACTCCAGTAACGCCTACT
CCACTGCAACTTGGGTTAC -> CACTGCAACTTGGGTTACT
CCACTTCAATTTCGTGGAA -> CACTTCAATTTCGTGGAAC
CCACTTCCGCTCCAGGTAC -> CACTTCCGCTCCAGGTACT
CCAGACTCTTTAGACTGCT -> CAGACTCTTTAGACTGCTG
CCAGATAGAAAGTATATCT -> CAGATAGAAAGTATATCTT
CCAGCAGCACGTCTCAAGG -> CAGCAGCACGTCTCAAGGT
CCAGGCTCTTGTCTTCACC -> CAGGCTCTTGTCTTCACCG
CCAGGTAACCGAGCACCTA -> CAGGTAACCGAGCACCTAC
CCAGGTACTGAATCGATCG -> CAGGTACTGAATCGATCGA
CCAGTAACGCCTACTGAAT -> CAGTAACGCCTACTGAATC
CCAGTCCACTAACTAAACC -> CAGTCCACTAACTAAACCG
CCAGTCTCCCCTTGGAAGA -> CAGTCTCCCCTTGGAAGAC
CCATAGACTGCTGACACCA -> CATAGACTGCTGACACCAC
CCATATCTTTAAGATAATT -> CATATCTTTAAGATAATTG
CCATCTGATATTTACGTGC -> CATCTGATATTTACGTGCG
CCATGACATACCCCTTTCC -> CATGACATACCCCTTTCCC
CCATGTCACATTCACCTAC -> CATGTCACATTCACCTACA
CCATTCGTTTATTAGAGCT -> CATTCGTTTATTAGAGCTT
CCCACAAAATCCCGAGGAG -> CCACAAAATCCCGAGGAGC
CCCACAAACTATTGAAATC -> CCACAAACTATTGAAATCT
CCCACTTCAATTTCGTGGA -> CCACTTCAATTTCGTGGAA
CCCCCTGAGGACTGGTTTA -> CCCCTGAGGACTGGTTTAA
CCCCTGAGGACTGGTTTAA -> CCCTGAGGACTGGTTTAAT
CCCCTTGGAAGACCCTTCA -> CCCTTGGAAGACCCTTCAT
CCCCTTGGTGTTTTAGTTA -> CCCTTGGTGTTTTAGTTAC
CCCCTTTCCCTAACGTACT -> CCCTTTCCCTAACGTACTT
CCCGAGGAGCCGCGCCAGA -> CCGAGGAGCCGCGCCAGAC
CCCGATCTATGGCGTTCAT -> CCGATCTATGGCGTTCATG
CCCGCGTGTCAGATGGTTG -> CCGCGTGTCAGATGGTTGG
CCCGTGGGGCGCCATAGAC -> CCGTGGGGCGCCATAGACT
CCCTAACGTACTTAGAACA -> CCTAACGTACTTAGAACAA
CCCTAGTATTTCATTCGCA -> CCTAGTATTTCATTCGCAC
CCCTCAGTTGACGTAACCT -> CCTCAGTTGACGTAACCTC
CCCTGAGGACTGGTTTAAT -> CCTGAGGACTGGTTTAATA
CCCTGGCTGCGACCCCTTG -> CCTGGCTGCGACCCCTTGG
CCCTGGGCTTCAACCTAGA -> CCTGGGCTTCAACCTAGAC
CCCTGTCTGCAGCGTATGG -> CCTGTCTGCAGCGTATGGG
CCCTTCATACACGTACGCG -> CCTTCATACACGTACGCGC
CCCTTGGAAGACCCTTCAT -> CCTTGGAAGACCCTTCATA
CCCTTGGTGTTTTAGTTAC -> CCTTGGTGTTTTAGTTACT
CCCTTTCCCTAACGTACTT -> CCTTTCCCTAACGTACTTA
CCGAAACCAGGCTCTTGTC -> CGAAACCAGGCTCTTGTCT
CCGAACAATCGACCAAGCT -> CGAACAATCGACCAAGCTT
CCGACACCTTTACCAGCAG -> CGACACCTTTACCAGCAGC
CCGACCTACCTTACTTCCC -> CGACCTACCTTACTTCCCG
CCGAGCACCTACGTTGATC -> CGAGCACCTACGTTGATCG
CCGAGGAGCCGCGCCAGAC -> CGAGGAGCCGCGCCAGACT
CCGATCTATGGCGTTCATG -> CGATCTATGGCGTTCATGC
CCGCACGGACAAGATATCA -> CGCACGGACAAGATATCAG
CCGCGCCAGACTCTTTAGA -> CGCGCCAGACTCTTTAGAC
CCGCGCGAAAATCGGCTTC -> CGCGCGAAAATCGGCTTCG
CCGCGCTTTTTTCTAGTTT -> CGCGCTTTTTTCTAGTTTA
CCGCGTGTCAGATGGTTGG -> CGCGTGTCAGATGGTTGGC
CCGCTCCAGGTACTGAATC -> CGCTCCAGGTACTGAATCG
CCGCTTCAATTTGCCTAGT -> CGCTTCAATTTGCCTAGTT
CCGGATAGGCCCACTTCAA -> CGGATAGGCCCACTTCAAT
CCGGCACATCTTGCATAAA -> CGGCACATCTTGCATAAAA
CCGGCACTTCCCCCTGAGG -> CGGCACTTCCCCCTGAGGA
CCGGCAGTCACATGCTAGT -> CGGCAGTCACATGCTAGTG
CCGGCTACTCGGTTCGTCA -> CGGCTACTCGGTTCGTCAG
CCGGTACATCGAATATTCA -> CGGTACATCGAATATTCAT
CCGGTATGCCTAGTAAGAC -> CGGTATGCCTAGTAAGACT
CCGTACGTCTTAAGACAGC -> CGTACGTCTTAAGACAGCA
CCGTGGGGCGCCATAGACT -> CGTGGGGCGCCATAGACTG
CCGTTCTACGCAGTTCCGG -> CGTTCTACGCAGTTCCGGC
CCTAACGTACTTAGAACAA -> CTAACGTACTTAGAACAAT
CCTACATATATAACGGCAT -> CTACATATATAACGGCATA
CCTACCCGATCTATGGCGT -> CTACCCGATCTATGGCGTT
CCTACCTTACTTCCCGCGT -> CTACCTTACTTCCCGCGTG
CCTACGTTGATCGTAAGCT -> CTACGTTGATCGTAAGCTC
CCTACTGAATCGATCGATC -> CTACTGAATCGATCGATCA,CTACTGAATCGATCGATCA
CCTAGACTGCTGACACCAC -> CTAGACTGCTGACACCACT
CCTAGTAAGACTGGCGCCG -> CTAGTAAGACTGGCGCCGC
CCTAGTATTTCATTCGCAC -> CTAGTATTTCATTCGCACT
CCTAGTTCACTGAAGACCA -> CTAGTTCACTGAAGACCAA
CCTCAACGAGAAGAGGTGT -> CTCAACGAGAAGAGGTGTG
CCTCAGTTGACGTAACCTC -> CTCAGTTGACGTAACCTCC
CCTCCATATCTTTAAGATA -> CTCCATATCTTTAAGATAA
CCTCCTGTAAGACATGATC -> CTCCTGTAAGACATGATCA
CCTCGACGTATCGATAACA -> CTCGACGTATCGATAACAG
CCTCGGTTAGCTTCTTTTC -> CTCGGTTAGCTTCTTTTCG
CCTCTGATCCTGGCCGACA -> CTCTGATCCTGGCCGACAC
CCTGAGCCTTACGCCTCGA -> CTGAGCCTTACGCCTCGAC
CCTGAGGACTGGTTTAATA -> CTGAGGACTGGTTTAATAA
CCTGCCTGCGGGTGGCTAA -> CTGCCTGCGGGTGGCTAAT
CCTGCGGGTGGCTAATAGG -> CTGCGGGTGGCTAATAGGT
CCTGGCCGACACCTTTACC -> CTGGCCGACACCTTTACCA
CCTGGCTGCGACCCCTTGG -> CTGGCTGCGACCCCTTGGT
CCTGGGCTTCAACCTAGAC -> CTGGGCTTCAACCTAGACT
CCTGGTAGCGCCAGTCCAC -> CTGGTAGCGCCAGTCCACT
CCTGTAAGACATGATCATC -> CTGTAAGACATGATCATCG
CCTGTAGCGGCGCCCTGGC -> CTGTAGCGGCGCCCTGGCT
CCTGTCTGCAGCGTATGGG -> CTGTCTGCAGCGTATGGGG
CCTTACGCCTCGACGTATC -> CTTACGCCTCGACGTATCG
CCTTACTTCCCGCGTGTCA -> CTTACTTCCCGCGTGTCAG
CCTTAGAGGCTGACCCTCA -> CTTAGAGGCTGACCCTCAG
CCTTATGGCTGAGCGATTC -> CTTATGGCTGAGCGATTCA
CCTTCATACACGTACGCGC -> CTTCATACACGTACGCGCC
CCTTCTTATCCTTGGAGGC -> CTTCTTATCCTTGGAGGCA
CCTTGGAAGACCCTTCATA -> CTTGGAAGACCCTTCATAC
CCTTGGAGGCAAGCGAGGG -> CTTGGAGGCAAGCGAGGGC
CCTTGGTGTTTTAGTTACT -> CTTGGTGTTTTAGTTACTT
CCTTTACCAGCAGCACGTC -> CTTTACCAGCAGCACGTCT
CCTTTCCCTAACGTACTTA -> CTTTCCCTAACGTACTTAG
CGAAAATCGGCTTCGCGTA -> GAAAATCGGCTTCGCGTAT
CGAAACCAGGCTCTTGTCT -> GAAACCAGGCTCTTGTCTT
CGAAATGTGTGCTCGGGTT -> GAAATGTGTGCTCGGGTTA
CGAACAATCGACCAAGCTT -> GAACAATCGACCAAGCTTT
CGAATATTCATAAGTCGCT -> GAATATTCATAAGTCGCTC
CGAATTCCAAGTGACGACT -> GAATTCCAAGTGACGACTA
CGACACCTTTACCAGCAGC -> GACACCTTTACCAGCAGCA
CGACCCCTTGGTGTTTTAG -> GACCCCTTGGTGTTTTAGT
CGACCTACCTTACTTCCCG -> GACCTACCTTACTTCCCGC
CGACGTATCGATAACAGAA -> GACGTATCGATAACAGAAG
CGACTAATTAAGTAGACTG -> GACTAATTAAGTAGACTGC
CGACTTCACAAGCGAATTC -> GACTTCACAAGCGAATTCC
CGAGAACAAGATGTTCGGC -> GAGAACAAGATGTTCGGCA
CGAGAAGAGGTGTGTAAAC -> GAGAAGAGGTGTGTAAACC
CGAGAGAATCGTTGCCGGT -> GAGAGAATCGTTGCCGGTA
CGAGCACCTACGTTGATCG -> GAGCACCTACGTTGATCGT
CGAGCTCTGCATACATGTT -> GAGCTCTGCATACATGTTT
CGAGGAGCCGCGCCAGACT -> GAGGAGCCGCGCCAGACTC
CGAGGCGGTCACTGACGAT -> GAGGCGGTCACTGACGATC
CGAGGGCACTGACAGATGA -> GAGGGCACTGACAGATGAT
CGAGGTAGTTGTGTTGATA -> GAGGTAGTTGTGTTGATAA
CGAGGTCAGCTCGGAAGTT -> GAGGTCAGCTCGGAAGTTA
CGAGTAGTTTATGCCGGTA -> GAGTAGTTTATGCCGGTAT
CGATAACAGAAGGGGCTCC -> GATAACAGAAGGGGCTCCT
CGATAACTCCATTCGTTTA -> GATAACTCCATTCGTTTAT
CGATCAAATTATCTGATTG -> GATCAAATTATCTGATTGG
CGATCAACCCACAAACTAT -> GATCAACCCACAAACTATT
CGATCAACTCATGAGAAGT -> GATCAACTCATGAGAAGTC
CGATCAATATCGCTGTCAA -> GATCAATATCGCTGTCAAT
CGATCACAAAGTCTTCCGC -> GATCACAAAGTCTTCCGCT
CGATCGATCAAATTATCTG -> GATCGATCAAATTATCTGA
CGATCGATCAACCCACAAA -> GATCGATCAACCCACAAAC
CGATCGATCAACTCATGAG -> GATCGATCAACTCATGAGA
CGATCGATCAATATCGCTG -> GATCGATCAATATCGCTGT
CGATCTATGGCGTTCATGC -> GATCTATGGCGTTCATGCT
CGATTCACAGCCAGTCTCC -> GATTCACAGCCAGTCTCCC
CGATTCGGATATCGGGCTC -> GATTCGGATATCGGGCTCG
CGCACGGACAAGATATCAG -> GCACGGACAAGATATCAGA
CGCACTTCCGAACAATCGA -> GCACTTCCGAACAATCGAC
CGCAGAATTGACCTCAACG -> GCAGAATTGACCTCAACGA
CGCAGTTCCGGCACTTCCC -> GCAGTTCCGGCACTTCCCC
CGCCAGACTCTTTAGACTG -> GCCAGACTCTTTAGACTGC
CGCCAGTCCACTAACTAAA -> GCCAGTCCACTAACTAAAC
CGCCATAGACTGCTGACAC -> GCCATAGACTGCTGACACC
CGCCCTGGCTGCGACCCCT -> GCCCTGGCTGCGACCCCTT
CGCCGACCTACCTTACTTC -> GCCGACCTACCTTACTTCC
CGCCGCACGGACAAGATAT -> GCCGCACGGACAAGATATC
CGCCTACCCGATCTATGGC -> GCCTACCCGATCTATGGCG
CGCCTACTGAATCGATCGA -> GCCTACTGAATCGATCGAT
CGCCTCGACGTATCGATAA -> GCCTCGACGTATCGATAAC
CGCGAAAATCGGCTTCGCG -> GCGAAAATCGGCTTCGCGT
CGCGAGGTAGTTGTGTTGA -> GCGAGGTAGTTGTGTTGAT
CGCGAGGTCAGCTCGGAAG -> GCGAGGTCAGCTCGGAAGT
CGCGCCAGACTCTTTAGAC -> GCGCCAGACTCTTTAGACT
CGCGCCGACCTACCTTACT -> GCGCCGACCTACCTTACTT
CGCGCGAAAATCGGCTTCG -> GCGCGAAAATCGGCTTCGC
CGCGCTTACGTAGGGAGAA -> GCGCTTACGTAGGGAGAAA
CGCGCTTTTTTCTAGTTTA -> GCGCTTTTTTCTAGTTTAG
CGCGGACGCTCAATGACGT -> GCGGACGCTCAATGACGTA
CGCGTATGACTGATTAGAA -> GCGTATGACTGATTAGAAG
CGCGTGTCAGATGGTTGGC -> GCGTGTCAGATGGTTGGCC
CGCGTTGCTATGACTGTGA -> GCGTTGCTATGACTGTGAA
CGCTACGTACGAAATGTGT -> GCTACGTACGAAATGTGTG
CGCTCAATGACGTAGGGAA -> GCTCAATGACGTAGGGAAC
CGCTCCAGGTACTGAATCG -> GCTCCAGGTACTGAATCGA
CGCTCCTGGTAGCGCCAGT -> GCTCCTGGTAGCGCCAGTC
CGCTGTCAATTCTTCTATC -> GCTGTCAATTCTTCTATCG
CGCTTACGTAGGGAGAAAA -> GCTTACGTAGGGAGAAAAA
CGCTTCAATTTGCCTAGTT -> GCTTCAATTTGCCTAGTTC
CGCTTTTTGGTGAGCGTGG -> GCTTTTTGGTGAGCGTGGG
CGCTTTTTTCTAGTTTAGG -> GCTTTTTTCTAGTTTAGGT
CGGAAAGGAAGTGTACGTG -> GGAAAGGAAGTGTACGTGA
CGGAAGTTATCTGATTAAT -> GGAAGTTATCTGATTAATA
CGGACAAGATATCAGATGG -> GGACAAGATATCAGATGGA
CGGACACTCGTCGTTGCCG -> GGACACTCGTCGTTGCCGT
CGGACGCTCAATGACGTAG -> GGACGCTCAATGACGTAGG
CGGATAGGCCCACTTCAAT -> GGATAGGCCCACTTCAATT
CGGATATAAAATCCGGATA -> GGATATAAAATCCGGATAG
CGGATATCGGGCTCGTACC -> GGATATCGGGCTCGTACCT
CGGCACATCTTGCATAAAA -> GGCACATCTTGCATAAAAT
CGGCACTTCCCCCTGAGGA -> GGCACTTCCCCCTGAGGAC
CGGCAGGAGCCATCTGATA -> GGCAGGAGCCATCTGATAT
CGGCAGTCACATGCTAGTG -> GGCAGTCACATGCTAGTGC
CGGCATAGGGGCATTCGCC -> GGCATAGGGGCATTCGCCT
CGGCGCCCTGGCTGCGACC -> GGCGCCCTGGCTGCGACCC
CGGCTACGACTTCACAAGC -> GGCTACGACTTCACAAGCG
CGGCTACTCGGTTCGTCAG -> GGCTACTCGGTTCGTCAGT
CGGCTGTGCTATACTGGAT -> GGCTGTGCTATACTGGATC
CGGCTTCCAGATAGAAAGT -> GGCTTCCAGATAGAAAGTA
CGGCTTCGCGTATGACTGA -> GGCTTCGCGTATGACTGAT
CGGGCAGTCAATTTAGTCA -> GGGCAGTCAATTTAGTCAG
CGGGCGTTCTCGAGGCGGT -> GGGCGTTCTCGAGGCGGTC
CGGGCTCGTACCTGCCTGC -> GGGCTCGTACCTGCCTGCG
CGGGTGGCTAATAGGTAGA -> GGGTGGCTAATAGGTAGAA
CGGGTTACTATCTGATGTT -> GGGTTACTATCTGATGTTA
CGGTACATCGAATATTCAT -> GGTACATCGAATATTCATA
CGGTATGCCTAGTAAGACT -> GGTATGCCTAGTAAGACTG
CGGTCACTGACGATCACAA -> GGTCACTGACGATCACAAA
CGGTGACACATCGGAAAGG -> GGTGACACATCGGAAAGGA
CGGTTAGCTTCTTTTCGAT -> GGTTAGCTTCTTTTCGATT
CGGTTCGTCAGTTCCTTAT -> GGTTCGTCAGTTCCTTATG
CGTAAATTAATTGTACGCT -> GTAAATTAATTGTACGCTA
CGTAACCTCCTGTAAGACA -> GTAACCTCCTGTAAGACAT
CGTAAGCTCATAGATTCGG -> GTAAGCTCATAGATTCGGC
CGTACCTGCCTGCGGGTGG -> GTACCTGCCTGCGGGTGGC
CGTACGAAATGTGTGCTCG -> GTACGAAATGTGTGCTCGG
CGTACGCGCCGACCTACCT -> GTACGCGCCGACCTACCTT
CGTACGTCTTAAGACAGCA -> GTACGTCTTAAGACAGCAA
CGTACTTAGAACAATTAAG -> GTACTTAGAACAATTAAGA
CGTAGGGAACCTCCATATC -> GTAGGGAACCTCCATATCT
CGTAGGGAGAAAAAAATCT -> GTAGGGAGAAAAAAATCTG
CGTATCGATAACAGAAGGG -> GTATCGATAACAGAAGGGG
CGTATGACTGATTAGAAGC -> GTATGACTGATTAGAAGCC
CGTATGGGGATTGCAGTGT -> GTATGGGGATTGCAGTGTC
CGTCAGTTCCTTATGGCTG -> GTCAGTTCCTTATGGCTGA
CGTCGGGCGTTCTCGAGGC -> GTCGGGCGTTCTCGAGGCG
CGTCGTTGCCGTTCTACGC -> GTCGTTGCCGTTCTACGCA
CGTCTCAAGGTCAAGACTG -> GTCTCAAGGTCAAGACTGT
CGTCTTAAGACAGCAACCT -> GTCTTAAGACAGCAACCTG
CGTGACGCGTTGCTATGAC -> GTGACGCGTTGCTATGACT
CGTGCGCGAGGTAGTTGTG -> GTGCGCGAGGTAGTTGTGT
CGTGGAACGGGCAGTCAAT -> GTGGAACGGGCAGTCAATT
CGTGGGCACCAGGTAACCG -> GTGGGCACCAGGTAACCGA
CGTGGGGCGCCATAGACTG -> GTGGGGCGCCATAGACTGC
CGTGTCAGATGGTTGGCCC -> GTGTCAGATGGTTGGCCCG
CGTTCATGCTTCACCACGA -> GTTCATGCTTCACCACGAG
CGTTCTACGCAGTTCCGGC -> GTTCTACGCAGTTCCGGCA
CGTTCTCGAGGCGGTCACT -> GTTCTCGAGGCGGTCACTG
CGTTGATCGTAAGCTCATA -> GTTGATCGTAAGCTCATAG
CGTTGCCGGTACATCGAAT -> GTTGCCGGTACATCGAATA
CGTTGCCGTTCTACGCAGT -> GTTGCCGTTCTACGCAGTT
CGTTGCTATGACTGTGAAG -> GTTGCTATGACTGTGAAGC
CGTTTATTAGAGCTTTCCC -> GTTTATTAGAGCTTTCCCA
CGTTTTGCCGCGCTTTTTT -> GTTTTGCCGCGCTTTTTTC
CTAAACCGTACGTCTTAAG -> TAAACCGTACGTCTTAAGA
CTAACGTACTTAGAACAAT -> TAACGTACTTAGAACAATT
CTAACTAAACCGTACGTCT -> TAACTAAACCGTACGTCTT
CTAATAGGTAGAAAGCAAT -> TAATAGGTAGAAAGCAATC
CTAATTAAGTAGACTGCTG -> TAATTAAGTAGACTGCTGA
CTACAATGCTTGCAAACTA -> TACAATGCTTGCAAACTAG
CTACATATATAACGGCATA -> TACATATATAACGGCATAG
CTACCCGATCTATGGCGTT -> TACCCGATCTATGGCGTTC
CTACCTTACTTCCCGCGTG -> TACCTTACTTCCCGCGTGT
CTACGACTTCACAAGCGAA -> TACGACTTCACAAGCGAAT
CTACGCAGTTCCGGCACTT -> TACGCAGTTCCGGCACTTC
CTACGTACGAAATGTGTGC -> TACGTACGAAATGTGTGCT
CTACGTTGATCGTAAGCTC -> TACGTTGATCGTAAGCTCA
CTACTCGGTTCGTCAGTTC -> TACTCGGTTCGTCAGTTCC
CTACTGAATCGATCGATCA -> TACTGAATCGATCGATCAA,TACTGAATCGATCGATCAA
CTAGAATGCTACAATGCTT -> TAGAATGCTACAATGCTTG
CTAGACTGCTGACACCACT -> TAGACTGCTGACACCACTC
CTAGAGGGCCTTCTTATCC -> TAGAGGGCCTTCTTATCCT
CTAGTAAGACTGGCGCCGC -> TAGTAAGACTGGCGCCGCA
CTAGTATTTCATTCGCACT -> TAGTATTTCATTCGCACTT
CTAGTGCTTGGCAGTATTG -> TAGTGCTTGGCAGTATTGC
CTAGTTCACTGAAGACCAA -> TAGTTCACTGAAGACCAAC
CTAGTTTAGGTAGGAGCTG -> TAGTTTAGGTAGGAGCTGG
CTATAATCGTCGGGCGTTC -> TATAATCGTCGGGCGTTCT
CTATACTGGATCGTTTTGC -> TATACTGGATCGTTTTGCC
CTATCGCAGAATTGACCTC -> TATCGCAGAATTGACCTCA
CTATCTGATGTTAAAACTG -> TATCTGATGTTAAAACTGC
CTATGACTGTGAAGCAGGT -> TATGACTGTGAAGCAGGTT
CTATGGCGTTCATGCTTCA -> TATGGCGTTCATGCTTCAC
CTATTCCAAAACCTACTGA -> TATTCCAAAACCTACTGAA
CTATTGAAATCTTCAGCTA -> TATTGAAATCTTCAGCTAG
CTCAACGAGAAGAGGTGTG -> TCAACGAGAAGAGGTGTGT
CTCAAGGTCAAGACTGTAT -> TCAAGGTCAAGACTGTATA
CTCAATGACGTAGGGAACC -> TCAATGACGTAGGGAACCT
CTCAGACACGGCTGTGCTA -> TCAGACACGGCTGTGCTAT
CTCAGTTGACGTAACCTCC -> TCAGTTGACGTAACCTCCT
CTCATAAGCATCCTCTGAT -> TCATAAGCATCCTCTGATC
CTCATAGATTCGGCTTCCA -> TCATAGATTCGGCTTCCAG
CTCATGAGAAGTCTGTGTA -> TCATGAGAAGTCTGTGTAC
CTCATTTCTCAGACACGGC -> TCATTTCTCAGACACGGCT
CTCCACTATAATCGTCGGG -> TCCACTATAATCGTCGGGC
CTCCAGGTACTGAATCGAT -> TCCAGGTACTGAATCGATC
CTCCAGTAACGCCTACTGA -> TCCAGTAACGCCTACTGAA
CTCCATATCTTTAAGATAA -> TCCATATCTTTAAGATAAT
CTCCATTCGTTTATTAGAG -> TCCATTCGTTTATTAGAGC
CTCCCCTTGGAAGACCCTT -> TCCCCTTGGAAGACCCTTC
CTCCTCGGTTAGCTTCTTT -> TCCTCGGTTAGCTTCTTTT
CTCCTGAGCCTTACGCCTC -> TCCTGAGCCTTACGCCTCG
CTCCTGGTAGCGCCAGTCC -> TCCTGGTAGCGCCAGTCCA
CTCCTGTAAGACATGATCA -> TCCTGTAAGACATGATCAT
CTCGACGTATCGATAACAG -> TCGACGTATCGATAACAGA
CTCGAGGCGGTCACTGACG -> TCGAGGCGGTCACTGACGA
CTCGGAAGTTATCTGATTA -> TCGGAAGTTATCTGATTAA
CTCGGGTTACTATCTGATG -> TCGGGTTACTATCTGATGT
CTCGGTTAGCTTCTTTTCG -> TCGGTTAGCTTCTTTTCGA
CTCGGTTCGTCAGTTCCTT -> TCGGTTCGTCAGTTCCTTA
CTCGTACCTGCCTGCGGGT -> TCGTACCTGCCTGCGGGTG
CTCGTCGTTGCCGTTCTAC -> TCGTCGTTGCCGTTCTACG
CTCTGATCCTGGCCGACAC -> TCTGATCCTGGCCGACACC
CTCTGCATACATGTTTTTA -> TCTGCATACATGTTTTTAT
CTCTTGTCTTCACCGGCTA -> TCTTGTCTTCACCGGCTAC
CTCTTTAGACTGCTGACAC -> TCTTTAGACTGCTGACACC
CTGAACACGTAAATTAATT -> TGAACACGTAAATTAATTG
CTGAAGACCAACAAAACCG -> TGAAGACCAACAAAACCGC
CTGAATCGATCGATCAAAT -> TGAATCGATCGATCAAATT
CTGAATCGATCGATCAACC -> TGAATCGATCGATCAACCC
CTGAATCGATCGATCAACT -> TGAATCGATCGATCAACTC
CTGAATCGATCGATCAATA -> TGAATCGATCGATCAATAT
CTGACACCACTATTCCAAA -> TGACACCACTATTCCAAAA
CTGACACCACTCCAGTAAC -> TGACACCACTCCAGTAACG
CTGACACCACTGCAACTTG -> TGACACCACTGCAACTTGG
CTGACACCACTTCCGCTCC -> TGACACCACTTCCGCTCCA
CTGACAGATGATGATTGTT -> TGACAGATGATGATTGTTA
CTGACCCTCAGTTGACGTA -> TGACCCTCAGTTGACGTAA
CTGACGATCACAAAGTCTT -> TGACGATCACAAAGTCTTC
CTGAGCCTTACGCCTCGAC -> TGAGCCTTACGCCTCGACG
CTGAGCGATTCACAGCCAG -> TGAGCGATTCACAGCCAGT
CTGAGGACTGGTTTAATAA -> TGAGGACTGGTTTAATAAC
CTGATATTTACGTGCGCGA -> TGATATTTACGTGCGCGAG
CTGATCCTGGCCGACACCT -> TGATCCTGGCCGACACCTT
CTGATGTTAAAACTGCGAG -> TGATGTTAAAACTGCGAGT
CTGATTAATATGCAGGTGC -> TGATTAATATGCAGGTGCA
CTGATTAGAAGCCGGCACA -> TGATTAGAAGCCGGCACAT
CTGATTGGTTAGCGGTGAC -> TGATTGGTTAGCGGTGACA
CTGCAACTTGGGTTACTGA -> TGCAACTTGGGTTACTGAA
CTGCAGCGTATGGGGATTG -> TGCAGCGTATGGGGATTGC
CTGCATACATGTTTTTATT -> TGCATACATGTTTTTATTT
CTGCCTGCGGGTGGCTAAT -> TGCCTGCGGGTGGCTAATA
CTGCGACCCCTTGGTGTTT -> TGCGACCCCTTGGTGTTTT
CTGCGAGTAGTTTATGCCG -> TGCGAGTAGTTTATGCCGG
CTGCGGGTGGCTAATAGGT -> TGCGGGTGGCTAATAGGTA
CTGCTGACACCACTATTCC -> TGCTGACACCACTATTCCA
CTGCTGACACCACTCCAGT -> TGCTGACACCACTCCAGTA
CTGCTGACACCACTGCAAC -> TGCTGACACCACTGCAACT
CTGCTGACACCACTTCCGC -> TGCTGACACCACTTCCGCT
CTGGATCGTTTTGCCGCGC -> TGGATCGTTTTGCCGCGCT
CTGGCATTGCCATGTCACA -> TGGCATTGCCATGTCACAT
CTGGCCGACACCTTTACCA -> TGGCCGACACCTTTACCAG
CTGGCGCCGCACGGACAAG -> TGGCGCCGCACGGACAAGA
CTGGCTGCGACCCCTTGGT -> TGGCTGCGACCCCTTGGTG
CTGGGCTTCAACCTAGACT -> TGGGCTTCAACCTAGACTG
CTGGGGCGCGAGGTCAGCT -> TGGGGCGCGAGGTCAGCTC
CTGGTAGCGCCAGTCCACT -> TGGTAGCGCCAGTCCACTA
CTGGTATGATCCATGACAT -> TGGTATGATCCATGACATA
CTGGTTTAATAACGGATAT -> TGGTTTAATAACGGATATA
CTGTAAGACATGATCATCG -> TGTAAGACATGATCATCGG
CTGTAGCGGCGCCCTGGCT -> TGTAGCGGCGCCCTGGCTG
CTGTATAGCGATAACTCCA -> TGTATAGCGATAACTCCAT
CTGTCAATTCTTCTATCGC -> TGTCAATTCTTCTATCGCA
CTGTCTGCAGCGTATGGGG -> TGTCTGCAGCGTATGGGGA
CTGTGAAGCAGGTTATCTG -> TGTGAAGCAGGTTATCTGG
CTGTGCTATACTGGATCGT -> TGTGCTATACTGGATCGTT
CTGTGTACTCCTGAGCCTT -> TGTGTACTCCTGAGCCTTA
CTTAAGACAGCAACCTGTA -> TTAAGACAGCAACCTGTAG
CTTACGCCTCGACGTATCG -> TTACGCCTCGACGTATCGA
CTTACGTAGGGAGAAAAAA -> TTACGTAGGGAGAAAAAAA
CTTACTTCCCGCGTGTCAG -> TTACTTCCCGCGTGTCAGA
CTTAGAACAATTAAGAGTA -> TTAGAACAATTAAGAGTAG
CTTAGAGGCTGACCCTCAG -> TTAGAGGCTGACCCTCAGT
CTTAGGATGTCAGCTCCAC -> TTAGGATGTCAGCTCCACT
CTTATCCTTGGAGGCAAGC -> TTATCCTTGGAGGCAAGCG
CTTATGGCTGAGCGATTCA -> TTATGGCTGAGCGATTCAC
CTTCAACCTAGACTGCTGA -> TTCAACCTAGACTGCTGAC
CTTCAATTTCGTGGAACGG -> TTCAATTTCGTGGAACGGG
CTTCAATTTGCCTAGTTCA -> TTCAATTTGCCTAGTTCAC
CTTCACAAGCGAATTCCAA -> TTCACAAGCGAATTCCAAG
CTTCACCACGAGCTCTGCA -> TTCACCACGAGCTCTGCAT
CTTCACCGGCTACTCGGTT -> TTCACCGGCTACTCGGTTC
CTTCAGCTAGAATGCTACA -> TTCAGCTAGAATGCTACAA
CTTCATACACGTACGCGCC -> TTCATACACGTACGCGCCG
CTTCCAGATAGAAAGTATA -> TTCCAGATAGAAAGTATAT
CTTCCCCCTGAGGACTGGT -> TTCCCCCTGAGGACTGGTT
CTTCCCGCGTGTCAGATGG -> TTCCCGCGTGTCAGATGGT
CTTCCGAACAATCGACCAA -> TTCCGAACAATCGACCAAG
CTTCCGCTCCAGGTACTGA -> TTCCGCTCCAGGTACTGAA
CTTCCGCTTCAATTTGCCT -> TTCCGCTTCAATTTGCCTA
CTTCGCGTATGACTGATTA -> TTCGCGTATGACTGATTAG
CTTCTATCGCAGAATTGAC -> TTCTATCGCAGAATTGACC
CTTCTTATCCTTGGAGGCA -> TTCTTATCCTTGGAGGCAA
CTTCTTTTCGATTCGGATA -> TTCTTTTCGATTCGGATAT
CTTGCAAACTAGAGGGCCT -> TTGCAAACTAGAGGGCCTT
CTTGCATAAAATTGCCCTG -> TTGCATAAAATTGCCCTGG
CTTGGAAGACCCTTCATAC -> TTGGAAGACCCTTCATACA
CTTGGAGGCAAGCGAGGGC -> TTGGAGGCAAGCGAGGGCA
CTTGGCAGTATTGCGCGGA -> TTGGCAGTATTGCGCGGAC
CTTGGGTTACTGAATCGAT -> TTGGGTTACTGAATCGATC
CTTGGTGTTTTAGTTACTT -> TTGGTGTTTTAGTTACTTT
CTTGTCTTCACCGGCTACT -> TTGTCTTCACCGGCTACTC
CTTTAAGATAATTGAGCCC -> TTTAAGATAATTGAGCCCT
CTTTACCAGCAGCACGTCT -> TTTACCAGCAGCACGTCTC
CTTTAGACTGCTGACACCA -> TTTAGACTGCTGACACCAC
CTTTCCCACAAAATCCCGA -> TTTCCCACAAAATCCCGAG
CTTTCCCTAACGTACTTAG -> TTTCCCTAACGTACTTAGA
CTTTTCAACCGAAACCAGG -> TTTTCAACCGAAACCAGGC
CTTTTCGATTCGGATATCG -> TTTTCGATTCGGATATCGG
CTTTTTGGTGAGCGTGGGC -> TTTTTGGTGAGCGTGGGCA
CTTTTTGTGATGCGAGAAC -> TTTTTGTGATGCGAGAACA
CTTTTTTCTAGTTTAGGTA -> TTTTTTCTAGTTTAGGTAG
GAAAAAAATCTGAACACGT -> AAAAAAATCTGAACACGTA
GAAAATCGGCTTCGCGTAT -> AAAATCGGCTTCGCGTATG
GAAACCAGGCTCTTGTCTT -> AAACCAGGCTCTTGTCTTC
GAAAGCAATCCTTAGAGGC -> AAAGCAATCCTTAGAGGCT
GAAAGGAAGTGTACGTGAC -> AAAGGAAGTGTACGTGACG
GAAAGTATATCTTAGGATG -> AAAGTATATCTTAGGATGT
GAAATCTTCAGCTAGAATG -> AAATCTTCAGCTAGAATGC
GAAATGTGTGCTCGGGTTA -> AAATGTGTGCTCGGGTTAC
GAACAAGATGTTCGGCAGG -> AACAAGATGTTCGGCAGGA
GAACAATCGACCAAGCTTT -> AACAATCGACCAAGCTTTG
GAACAATTAAGAGTAGTTT -> AACAATTAAGAGTAGTTTT
GAACACGTAAATTAATTGT -> AACACGTAAATTAATTGTA
GAACCTCCATATCTTTAAG -> AACCTCCATATCTTTAAGA
GAACGGGCAGTCAATTTAG -> AACGGGCAGTCAATTTAGT
GAACTGGCATTGCCATGTC -> AACTGGCATTGCCATGTCA
GAAGACCAACAAAACCGCG -> AAGACCAACAAAACCGCGC
GAAGACCCTTCATACACGT -> AAGACCCTTCATACACGTA
GAAGAGGTGTGTAAACCCT -> AAGAGGTGTGTAAACCCTG
GAAGCAGGTTATCTGGGGC -> AAGCAGGTTATCTGGGGCG
GAAGCCGGCACATCTTGCA -> AAGCCGGCACATCTTGCAT
GAAGGGGCTCCTCGGTTAG -> AAGGGGCTCCTCGGTTAGC
GAAGTCTGTGTACTCCTGA -> AAGTCTGTGTACTCCTGAG
GAAGTGTACGTGACGCGTT -> AAGTGTACGTGACGCGTTG
GAAGTTATCTGATTAATAT -> AAGTTATCTGATTAATATG
GAATATTCATAAGTCGCTC -> AATATTCATAAGTCGCTCC
GAATCGATCGATCAAATTA -> AATCGATCGATCAAATTAT
GAATCGATCGATCAACCCA -> AATCGATCGATCAACCCAC
GAATCGATCGATCAACTCA -> AATCGATCGATCAACTCAT
GAATCGATCGATCAATATC -> AATCGATCGATCAATATCG
GAATCGTTGCCGGTACATC -> AATCGTTGCCGGTACATCG
GAATGCTACAATGCTTGCA -> AATGCTACAATGCTTGCAA
GAATTCCAAGTGACGACTA -> AATTCCAAGTGACGACTAA
GAATTGACCTCAACGAGAA -> AATTGACCTCAACGAGAAG
GACAAGATATCAGATGGAG -> ACAAGATATCAGATGGAGA
GACACATCGGAAAGGAAGT -> ACACATCGGAAAGGAAGTG
GACACCACTATTCCAAAAC -> ACACCACTATTCCAAAACC
GACACCACTCCAGTAACGC -> ACACCACTCCAGTAACGCC
GACACCACTGCAACTTGGG -> ACACCACTGCAACTTGGGT
GACACCACTTCCGCTCCAG -> ACACCACTTCCGCTCCAGG
GACACCTTTACCAGCAGCA -> ACACCTTTACCAGCAGCAC
GACACGGCTGTGCTATACT -> ACACGGCTGTGCTATACTG
GACACTCGTCGTTGCCGTT -> ACACTCGTCGTTGCCGTTC
GACAGATGATGATTGTTAC -> ACAGATGATGATTGTTACC
GACAGCAACCTGTAGCGGC -> ACAGCAACCTGTAGCGGCG
GACATACCCCTTTCCCTAA -> ACATACCCCTTTCCCTAAC
GACATGATCATCGGACACT -> ACATGATCATCGGACACTC
GACCAACAAAACCGCGCGA -> ACCAACAAAACCGCGCGAA
GACCCCTTGGTGTTTTAGT -> ACCCCTTGGTGTTTTAGTT
GACCCTCAGTTGACGTAAC -> ACCCTCAGTTGACGTAACC
GACCCTTCATACACGTACG -> ACCCTTCATACACGTACGC
GACCTACCTTACTTCCCGC -> ACCTACCTTACTTCCCGCG
GACCTCAACGAGAAGAGGT -> ACCTCAACGAGAAGAGGTG
GACGACTAATTAAGTAGAC -> ACGACTAATTAAGTAGACT
GACGATCACAAAGTCTTCC -> ACGATCACAAAGTCTTCCG
GACGCGTTGCTATGACTGT -> ACGCGTTGCTATGACTGTG
GACGCTCAATGACGTAGGG -> ACGCTCAATGACGTAGGGA
GACGTAACCTCCTGTAAGA -> ACGTAACCTCCTGTAAGAC
GACGTAGGGAACCTCCATA -> ACGTAGGGAACCTCCATAT
GACGTATCGATAACAGAAG -> ACGTATCGATAACAGAAGG
GACTAATTAAGTAGACTGC -> ACTAATTAAGTAGACTGCT
GACTCATAAGCATCCTCTG -> ACTCATAAGCATCCTCTGA
GACTCTTTAGACTGCTGAC -> ACTCTTTAGACTGCTGACA
GACTGATTAGAAGCCGGCA -> ACTGATTAGAAGCCGGCAC
GACTGCTGACACCACTATT -> ACTGCTGACACCACTATTC
GACTGCTGACACCACTCCA -> ACTGCTGACACCACTCCAG
GACTGCTGACACCACTGCA -> ACTGCTGACACCACTGCAA
GACTGCTGACACCACTTCC -> ACTGCTGACACCACTTCCG
GACTGGCGCCGCACGGACA -> ACTGGCGCCGCACGGACAA
GACTGGTTTAATAACGGAT -> ACTGGTTTAATAACGGATA
GACTGTATAGCGATAACTC -> ACTGTATAGCGATAACTCC
GACTGTGAAGCAGGTTATC -> ACTGTGAAGCAGGTTATCT
GACTTCACAAGCGAATTCC -> ACTTCACAAGCGAATTCCA
GAGAAAAAAATCTGAACAC -> AGAAAAAAATCTGAACACG
GAGAACAAGATGTTCGGCA -> AGAACAAGATGTTCGGCAG
GAGAAGAGGTGTGTAAACC -> AGAAGAGGTGTGTAAACCC
GAGAAGTCTGTGTACTCCT -> AGAAGTCTGTGTACTCCTG
GAGAATCGTTGCCGGTACA -> AGAATCGTTGCCGGTACAT
GAGACTCATAAGCATCCTC -> AGACTCATAAGCATCCTCT
GAGAGAATCGTTGCCGGTA -> AGAGAATCGTTGCCGGTAC
GAGCACCTACGTTGATCGT -> AGCACCTACGTTGATCGTA
GAGCCATCTGATATTTACG -> AGCCATCTGATATTTACGT
GAGCCCTAGTATTTCATTC -> AGCCCTAGTATTTCATTCG
GAGCCGCGCCAGACTCTTT -> AGCCGCGCCAGACTCTTTA
GAGCCTTACGCCTCGACGT -> AGCCTTACGCCTCGACGTA
GAGCGATTCACAGCCAGTC -> AGCGATTCACAGCCAGTCT
GAGCGTGGGCACCAGGTAA -> AGCGTGGGCACCAGGTAAC
GAGCTCTGCATACATGTTT -> AGCTCTGCATACATGTTTT
GAGCTGGTATGATCCATGA -> AGCTGGTATGATCCATGAC
GAGCTTTCCCACAAAATCC -> AGCTTTCCCACAAAATCCC
GAGGACTGGTTTAATAACG -> AGGACTGGTTTAATAACGG
GAGGAGCCGCGCCAGACTC -> AGGAGCCGCGCCAGACTCT
GAGGCAAGCGAGGGCACTG -> AGGCAAGCGAGGGCACTGA
GAGGCGGTCACTGACGATC -> AGGCGGTCACTGACGATCA
GAGGCTGACCCTCAGTTGA -> AGGCTGACCCTCAGTTGAC
GAGGGCACTGACAGATGAT -> AGGGCACTGACAGATGATG
GAGGGCCTTCTTATCCTTG -> AGGGCCTTCTTATCCTTGG
GAGGTAGTTGTGTTGATAA -> AGGTAGTTGTGTTGATAAA
GAGGTCAGCTCGGAAGTTA -> AGGTCAGCTCGGAAGTTAT
GAGGTGTGTAAACCCTGTC -> AGGTGTGTAAACCCTGTCT
GAGTAGTTTATGCCGGTAT -> AGTAGTTTATGCCGGTATG
GAGTAGTTTTCTTTTCAAC -> AGTAGTTTTCTTTTCAACC
GATAAAGATCAAAGAACTG -> ATAAAGATCAAAGAACTGG
GATAACAGAAGGGGCTCCT -> ATAACAGAAGGGGCTCCTC
GATAACTCCATTCGTTTAT -> ATAACTCCATTCGTTTATT
GATAATTGAGCCCTAGTAT -> ATAATTGAGCCCTAGTATT
GATAGAAAGTATATCTTAG -> ATAGAAAGTATATCTTAGG
GATAGGCCCACTTCAATTT -> ATAGGCCCACTTCAATTTC
GATATAAAATCCGGATAGG -> ATATAAAATCCGGATAGGC
GATATCAGATGGAGACTCA -> ATATCAGATGGAGACTCAT
GATATCGGGCTCGTACCTG -> ATATCGGGCTCGTACCTGC
GATATTTACGTGCGCGAGG -> ATATTTACGTGCGCGAGGT
GATCAAAGAACTGGCATTG -> ATCAAAGAACTGGCATTGC
GATCAAATTATCTGATTGG -> ATCAAATTATCTGATTGGT
GATCAACCCACAAACTATT -> ATCAACCCACAAACTATTG
GATCAACTCATGAGAAGTC -> ATCAACTCATGAGAAGTCT
GATCAATATCGCTGTCAAT -> ATCAATATCGCTGTCAATT
GATCACAAAGTCTTCCGCT -> ATCACAAAGTCTTCCGCTT
GATCATCGGACACTCGTCG -> ATCATCGGACACTCGTCGT
GATCCATGACATACCCCTT -> ATCCATGACATACCCCTTT
GATCCTGGCCGACACCTTT -> ATCCTGGCCGACACCTTTA
GATCGATCAAATTATCTGA -> ATCGATCAAATTATCTGAT
GATCGATCAACCCACAAAC -> ATCGATCAACCCACAAACT
GATCGATCAACTCATGAGA -> ATCGATCAACTCATGAGAA
GATCGATCAATATCGCTGT -> ATCGATCAATATCGCTGTC
GATCGTAAGCTCATAGATT -> ATCGTAAGCTCATAGATTC
GATCGTTTTGCCGCGCTTT -> ATCGTTTTGCCGCGCTTTT
GATCTATGGCGTTCATGCT -> ATCTATGGCGTTCATGCTT
GATGATGATTGTTACCGGC -> ATGATGATTGTTACCGGCA
GATGATTGTTACCGGCAGT -> ATGATTGTTACCGGCAGTC
GATGCGAGAACAAGATGTT -> ATGCGAGAACAAGATGTTC
GATGGAGACTCATAAGCAT -> ATGGAGACTCATAAGCATC
GATGGTTGGCCCGTGGGGC -> ATGGTTGGCCCGTGGGGCG
GATGTCAGCTCCACTATAA -> ATGTCAGCTCCACTATAAT
GATGTTAAAACTGCGAGTA -> ATGTTAAAACTGCGAGTAG
GATGTTCGGCAGGAGCCAT -> ATGTTCGGCAGGAGCCATC
GATTAATATGCAGGTGCAT -> ATTAATATGCAGGTGCATC
GATTAGAAGCCGGCACATC -> ATTAGAAGCCGGCACATCT
GATTCACAGCCAGTCTCCC -> ATTCACAGCCAGTCTCCCC
GATTCGGATATCGGGCTCG -> ATTCGGATATCGGGCTCGT
GATTCGGCTTCCAGATAGA -> ATTCGGCTTCCAGATAGAA
GATTGCAGTGTCGCTTTTT -> ATTGCAGTGTCGCTTTTTG
GATTGGTTAGCGGTGACAC -> ATTGGTTAGCGGTGACACA
GATTGTTACCGGCAGTCAC -> ATTGTTACCGGCAGTCACA
GCAAACTAGAGGGCCTTCT -> CAAACTAGAGGGCCTTCTT
GCAACCTGTAGCGGCGCCC -> CAACCTGTAGCGGCGCCCT
GCAACTTGGGTTACTGAAT -> CAACTTGGGTTACTGAATC
GCAAGCGAGGGCACTGACA -> CAAGCGAGGGCACTGACAG
GCAATCCTTAGAGGCTGAC -> CAATCCTTAGAGGCTGACC
GCACATCTTGCATAAAATT -> CACATCTTGCATAAAATTG
GCACCAGGTAACCGAGCAC -> CACCAGGTAACCGAGCACC
GCACCTACGTTGATCGTAA -> CACCTACGTTGATCGTAAG
GCACGGACAAGATATCAGA -> CACGGACAAGATATCAGAT
GCACGTCTCAAGGTCAAGA -> CACGTCTCAAGGTCAAGAC
GCACTGACAGATGATGATT -> CACTGACAGATGATGATTG
GCACTTCCCCCTGAGGACT -> CACTTCCCCCTGAGGACTG
GCACTTCCGAACAATCGAC -> CACTTCCGAACAATCGACC
GCAGAATTGACCTCAACGA -> CAGAATTGACCTCAACGAG
GCAGCACGTCTCAAGGTCA -> CAGCACGTCTCAAGGTCAA
GCAGCGTATGGGGATTGCA -> CAGCGTATGGGGATTGCAG
GCAGGAGCCATCTGATATT -> CAGGAGCCATCTGATATTT
GCAGGTGCATCGGCTACGA -> CAGGTGCATCGGCTACGAC
GCAGGTTATCTGGGGCGCG -> CAGGTTATCTGGGGCGCGA
GCAGTATTGCGCGGACGCT -> CAGTATTGCGCGGACGCTC
GCAGTCAATTTAGTCAGTG -> CAGTCAATTTAGTCAGTGT
GCAGTCACATGCTAGTGCT -> CAGTCACATGCTAGTGCTT
GCAGTGTCGCTTTTTGGTG -> CAGTGTCGCTTTTTGGTGA
GCAGTTCCGGCACTTCCCC -> CAGTTCCGGCACTTCCCCC
GCATAAAATTGCCCTGGGC -> CATAAAATTGCCCTGGGCT
GCATACATGTTTTTATTTA -> CATACATGTTTTTATTTAC
GCATAGGGGCATTCGCCTA -> CATAGGGGCATTCGCCTAC
GCATCCTCTGATCCTGGCC -> CATCCTCTGATCCTGGCCG
GCATCGGCTACGACTTCAC -> CATCGGCTACGACTTCACA
GCATTCGCCTACCCGATCT -> CATTCGCCTACCCGATCTA
GCATTGCCATGTCACATTC -> CATTGCCATGTCACATTCA
GCCAGACTCTTTAGACTGC -> CCAGACTCTTTAGACTGCT
GCCAGTCCACTAACTAAAC -> CCAGTCCACTAACTAAACC
GCCAGTCTCCCCTTGGAAG -> CCAGTCTCCCCTTGGAAGA
GCCATAGACTGCTGACACC -> CCATAGACTGCTGACACCA
GCCATCTGATATTTACGTG -> CCATCTGATATTTACGTGC
GCCATGTCACATTCACCTA -> CCATGTCACATTCACCTAC
GCCCACTTCAATTTCGTGG -> CCCACTTCAATTTCGTGGA
GCCCGTGGGGCGCCATAGA -> CCCGTGGGGCGCCATAGAC
GCCCTAGTATTTCATTCGC -> CCCTAGTATTTCATTCGCA
GCCCTGGCTGCGACCCCTT -> CCCTGGCTGCGACCCCTTG
GCCCTGGGCTTCAACCTAG -> CCCTGGGCTTCAACCTAGA
GCCGACACCTTTACCAGCA -> CCGACACCTTTACCAGCAG
GCCGACCTACCTTACTTCC -> CCGACCTACCTTACTTCCC
GCCGCACGGACAAGATATC -> CCGCACGGACAAGATATCA
GCCGCGCCAGACTCTTTAG -> CCGCGCCAGACTCTTTAGA
GCCGCGCTTTTTTCTAGTT -> CCGCGCTTTTTTCTAGTTT
GCCGGCACATCTTGCATAA -> CCGGCACATCTTGCATAAA
GCCGGTACATCGAATATTC -> CCGGTACATCGAATATTCA
GCCGGTATGCCTAGTAAGA -> CCGGTATGCCTAGTAAGAC
GCCGTTCTACGCAGTTCCG -> CCGTTCTACGCAGTTCCGG
GCCTACCCGATCTATGGCG -> CCTACCCGATCTATGGCGT
GCCTACTGAATCGATCGAT -> CCTACTGAATCGATCGATC
GCCTAGTAAGACTGGCGCC -> CCTAGTAAGACTGGCGCCG
GCCTAGTTCACTGAAGACC -> CCTAGTTCACTGAAGACCA
GCCTCGACGTATCGATAAC -> CCTCGACGTATCGATAACA
GCCTGCGGGTGGCTAATAG -> CCTGCGGGTGGCTAATAGG
GCCTTACGCCTCGACGTAT -> CCTTACGCCTCGACGTATC
GCCTTCTTATCCTTGGAGG -> CCTTCTTATCCTTGGAGGC
GCGAAAATCGGCTTCGCGT -> CGAAAATCGGCTTCGCGTA
GCGAATTCCAAGTGACGAC -> CGAATTCCAAGTGACGACT
GCGACCCCTTGGTGTTTTA -> CGACCCCTTGGTGTTTTAG
GCGAGAACAAGATGTTCGG -> CGAGAACAAGATGTTCGGC
GCGAGAGAATCGTTGCCGG -> CGAGAGAATCGTTGCCGGT
GCGAGGGCACTGACAGATG -> CGAGGGCACTGACAGATGA
GCGAGGTAGTTGTGTTGAT -> CGAGGTAGTTGTGTTGATA
GCGAGGTCAGCTCGGAAGT -> CGAGGTCAGCTCGGAAGTT
GCGAGTAGTTTATGCCGGT -> CGAGTAGTTTATGCCGGTA
GCGATAACTCCATTCGTTT -> CGATAACTCCATTCGTTTA
GCGATTCACAGCCAGTCTC -> CGATTCACAGCCAGTCTCC
GCGCCAGACTCTTTAGACT -> CGCCAGACTCTTTAGACTG
GCGCCAGTCCACTAACTAA -> CGCCAGTCCACTAACTAAA
GCGCCATAGACTGCTGACA -> CGCCATAGACTGCTGACAC
GCGCCCTGGCTGCGACCCC -> CGCCCTGGCTGCGACCCCT
GCGCCGACCTACCTTACTT -> CGCCGACCTACCTTACTTC
GCGCCGCACGGACAAGATA -> CGCCGCACGGACAAGATAT
GCGCGAAAATCGGCTTCGC -> CGCGAAAATCGGCTTCGCG
GCGCGAGGTAGTTGTGTTG -> CGCGAGGTAGTTGTGTTGA
GCGCGAGGTCAGCTCGGAA -> CGCGAGGTCAGCTCGGAAG
GCGCGGACGCTCAATGACG -> CGCGGACGCTCAATGACGT
GCGCTTACGTAGGGAGAAA -> CGCTTACGTAGGGAGAAAA
GCGCTTTTTTCTAGTTTAG -> CGCTTTTTTCTAGTTTAGG
GCGGACGCTCAATGACGTA -> CGGACGCTCAATGACGTAG
GCGGCGCCCTGGCTGCGAC -> CGGCGCCCTGGCTGCGACC
GCGGGTGGCTAATAGGTAG -> CGGGTGGCTAATAGGTAGA
GCGGTCACTGACGATCACA -> CGGTCACTGACGATCACAA
GCGGTGACACATCGGAAAG -> CGGTGACACATCGGAAAGG
GCGTATGACTGATTAGAAG -> CGTATGACTGATTAGAAGC
GCGTATGGGGATTGCAGTG -> CGTATGGGGATTGCAGTGT
GCGTGGGCACCAGGTAACC -> CGTGGGCACCAGGTAACCG
GCGTGTCAGATGGTTGGCC -> CGTGTCAGATGGTTGGCCC
GCGTTCATGCTTCACCACG -> CGTTCATGCTTCACCACGA
GCGTTCTCGAGGCGGTCAC -> CGTTCTCGAGGCGGTCACT
GCGTTGCTATGACTGTGAA -> CGTTGCTATGACTGTGAAG
GCTAATAGGTAGAAAGCAA -> CTAATAGGTAGAAAGCAAT
GCTACAATGCTTGCAAACT -> CTACAATGCTTGCAAACTA
GCTACGACTTCACAAGCGA -> CTACGACTTCACAAGCGAA
GCTACGTACGAAATGTGTG -> CTACGTACGAAATGTGTGC
GCTACTCGGTTCGTCAGTT -> CTACTCGGTTCGTCAGTTC
GCTAGAATGCTACAATGCT -> CTAGAATGCTACAATGCTT
GCTAGTGCTTGGCAGTATT -> CTAGTGCTTGGCAGTATTG
GCTATACTGGATCGTTTTG -> CTATACTGGATCGTTTTGC
GCTATGACTGTGAAGCAGG -> CTATGACTGTGAAGCAGGT
GCTCAATGACGTAGGGAAC -> CTCAATGACGTAGGGAACC
GCTCATAGATTCGGCTTCC -> CTCATAGATTCGGCTTCCA
GCTCCACTATAATCGTCGG -> CTCCACTATAATCGTCGGG
GCTCCAGGTACTGAATCGA -> CTCCAGGTACTGAATCGAT
GCTCCTCGGTTAGCTTCTT -> CTCCTCGGTTAGCTTCTTT
GCTCCTGGTAGCGCCAGTC -> CTCCTGGTAGCGCCAGTCC
GCTCGGAAGTTATCTGATT -> CTCGGAAGTTATCTGATTA
GCTCGGGTTACTATCTGAT -> CTCGGGTTACTATCTGATG
GCTCGTACCTGCCTGCGGG -> CTCGTACCTGCCTGCGGGT
GCTCTGCATACATGTTTTT -> CTCTGCATACATGTTTTTA
GCTCTTGTCTTCACCGGCT -> CTCTTGTCTTCACCGGCTA
GCTGACACCACTATTCCAA -> CTGACACCACTATTCCAAA
GCTGACACCACTCCAGTAA -> CTGACACCACTCCAGTAAC
GCTGACACCACTGCAACTT -> CTGACACCACTGCAACTTG
GCTGACACCACTTCCGCTC -> CTGACACCACTTCCGCTCC
GCTGACCCTCAGTTGACGT -> CTGACCCTCAGTTGACGTA
GCTGAGCGATTCACAGCCA -> CTGAGCGATTCACAGCCAG
GCTGCGACCCCTTGGTGTT -> CTGCGACCCCTTGGTGTTT
GCTGGTATGATCCATGACA -> CTGGTATGATCCATGACAT
GCTGTCAATTCTTCTATCG -> CTGTCAATTCTTCTATCGC
GCTGTGCTATACTGGATCG -> CTGTGCTATACTGGATCGT
GCTTACGTAGGGAGAAAAA -> CTTACGTAGGGAGAAAAAA
GCTTCAACCTAGACTGCTG -> CTTCAACCTAGACTGCTGA
GCTTCAATTTGCCTAGTTC -> CTTCAATTTGCCTAGTTCA
GCTTCACCACGAGCTCTGC -> CTTCACCACGAGCTCTGCA
GCTTCCAGATAGAAAGTAT -> CTTCCAGATAGAAAGTATA
GCTTCGCGTATGACTGATT -> CTTCGCGTATGACTGATTA
GCTTCTTTTCGATTCGGAT -> CTTCTTTTCGATTCGGATA
GCTTGCAAACTAGAGGGCC -> CTTGCAAACTAGAGGGCCT
GCTTGGCAGTATTGCGCGG -> CTTGGCAGTATTGCGCGGA
GCTTTCCCACAAAATCCCG -> CTTTCCCACAAAATCCCGA
GCTTTTTGGTGAGCGTGGG -> CTTTTTGGTGAGCGTGGGC
GCTTTTTTCTAGTTTAGGT -> CTTTTTTCTAGTTTAGGTA
GGAAAGGAAGTGTACGTGA -> GAAAGGAAGTGTACGTGAC
GGAACCTCCATATCTTTAA -> GAACCTCCATATCTTTAAG
GGAACGGGCAGTCAATTTA -> GAACGGGCAGTCAATTTAG
GGAAGACCCTTCATACACG -> GAAGACCCTTCATACACGT
GGAAGTGTACGTGACGCGT -> GAAGTGTACGTGACGCGTT
GGAAGTTATCTGATTAATA -> GAAGTTATCTGATTAATAT
GGACAAGATATCAGATGGA -> GACAAGATATCAGATGGAG
GGACACTCGTCGTTGCCGT -> GACACTCGTCGTTGCCGTT
GGACGCTCAATGACGTAGG -> GACGCTCAATGACGTAGGG
GGACTGGTTTAATAACGGA -> GACTGGTTTAATAACGGAT
GGAGAAAAAAATCTGAACA -> GAGAAAAAAATCTGAACAC
GGAGACTCATAAGCATCCT -> GAGACTCATAAGCATCCTC
GGAGCCATCTGATATTTAC -> GAGCCATCTGATATTTACG
GGAGCCGCGCCAGACTCTT -> GAGCCGCGCCAGACTCTTT
GGAGCTGGTATGATCCATG -> GAGCTGGTATGATCCATGA
GGAGGCAAGCGAGGGCACT -> GAGGCAAGCGAGGGCACTG
GGATAGGCCCACTTCAATT -> GATAGGCCCACTTCAATTT
GGATATAAAATCCGGATAG -> GATATAAAATCCGGATAGG
GGATATCGGGCTCGTACCT -> GATATCGGGCTCGTACCTG
GGATCGTTTTGCCGCGCTT -> GATCGTTTTGCCGCGCTTT
GGATGTCAGCTCCACTATA -> GATGTCAGCTCCACTATAA
GGATTGCAGTGTCGCTTTT -> GATTGCAGTGTCGCTTTTT
GGCAAGCGAGGGCACTGAC -> GCAAGCGAGGGCACTGACA
GGCACATCTTGCATAAAAT -> GCACATCTTGCATAAAATT
GGCACCAGGTAACCGAGCA -> GCACCAGGTAACCGAGCAC
GGCACTGACAGATGATGAT -> GCACTGACAGATGATGATT
GGCACTTCCCCCTGAGGAC -> GCACTTCCCCCTGAGGACT
GGCAGGAGCCATCTGATAT -> GCAGGAGCCATCTGATATT
GGCAGTATTGCGCGGACGC -> GCAGTATTGCGCGGACGCT
GGCAGTCAATTTAGTCAGT -> GCAGTCAATTTAGTCAGTG
GGCAGTCACATGCTAGTGC -> GCAGTCACATGCTAGTGCT
GGCATAGGGGCATTCGCCT -> GCATAGGGGCATTCGCCTA
GGCATTCGCCTACCCGATC -> GCATTCGCCTACCCGATCT
GGCATTGCCATGTCACATT -> GCATTGCCATGTCACATTC
GGCCCACTTCAATTTCGTG -> GCCCACTTCAATTTCGTGG
GGCCCGTGGGGCGCCATAG -> GCCCGTGGGGCGCCATAGA
GGCCGACACCTTTACCAGC -> GCCGACACCTTTACCAGCA
GGCCTTCTTATCCTTGGAG -> GCCTTCTTATCCTTGGAGG
GGCGAGAGAATCGTTGCCG -> GCGAGAGAATCGTTGCCGG
GGCGCCATAGACTGCTGAC -> GCGCCATAGACTGCTGACA
GGCGCCCTGGCTGCGACCC -> GCGCCCTGGCTGCGACCCC
GGCGCCGCACGGACAAGAT -> GCGCCGCACGGACAAGATA
GGCGCGAGGTCAGCTCGGA -> GCGCGAGGTCAGCTCGGAA
GGCGGTCACTGACGATCAC -> GCGGTCACTGACGATCACA
GGCGTTCATGCTTCACCAC -> GCGTTCATGCTTCACCACG
GGCGTTCTCGAGGCGGTCA -> GCGTTCTCGAGGCGGTCAC
GGCTAATAGGTAGAAAGCA -> GCTAATAGGTAGAAAGCAA
GGCTACGACTTCACAAGCG -> GCTACGACTTCACAAGCGA
GGCTACTCGGTTCGTCAGT -> GCTACTCGGTTCGTCAGTT
GGCTCCTCGGTTAGCTTCT -> GCTCCTCGGTTAGCTTCTT
GGCTCGTACCTGCCTGCGG -> GCTCGTACCTGCCTGCGGG
GGCTCTTGTCTTCACCGGC -> GCTCTTGTCTTCACCGGCT
GGCTGACCCTCAGTTGACG -> GCTGACCCTCAGTTGACGT
GGCTGAGCGATTCACAGCC -> GCTGAGCGATTCACAGCCA
GGCTGCGACCCCTTGGTGT -> GCTGCGACCCCTTGGTGTT
GGCTGTGCTATACTGGATC -> GCTGTGCTATACTGGATCG
GGCTTCAACCTAGACTGCT -> GCTTCAACCTAGACTGCTG
GGCTTCCAGATAGAAAGTA -> GCTTCCAGATAGAAAGTAT
GGCTTCGCGTATGACTGAT -> GCTTCGCGTATGACTGATT
GGGAACCTCCATATCTTTA -> GGAACCTCCATATCTTTAA
GGGAGAAAAAAATCTGAAC -> GGAGAAAAAAATCTGAACA
GGGATTGCAGTGTCGCTTT -> GGATTGCAGTGTCGCTTTT
GGGCACCAGGTAACCGAGC -> GGCACCAGGTAACCGAGCA
GGGCACTGACAGATGATGA -> GGCACTGACAGATGATGAT
GGGCAGTCAATTTAGTCAG -> GGCAGTCAATTTAGTCAGT
GGGCATTCGCCTACCCGAT -> GGCATTCGCCTACCCGATC
GGGCCTTCTTATCCTTGGA -> GGCCTTCTTATCCTTGGAG
GGGCGCCATAGACTGCTGA -> GGCGCCATAGACTGCTGAC
GGGCGCGAGGTCAGCTCGG -> GGCGCGAGGTCAGCTCGGA
GGGCGTTCTCGAGGCGGTC -> GGCGTTCTCGAGGCGGTCA
GGGCTCCTCGGTTAGCTTC -> GGCTCCTCGGTTAGCTTCT
GGGCTCGTACCTGCCTGCG -> GGCTCGTACCTGCCTGCGG
GGGCTTCAACCTAGACTGC -> GGCTTCAACCTAGACTGCT
GGGGATTGCAGTGTCGCTT -> GGGATTGCAGTGTCGCTTT
GGGGCATTCGCCTACCCGA -> GGGCATTCGCCTACCCGAT
GGGGCGCCATAGACTGCTG -> GGGCGCCATAGACTGCTGA
GGGGCGCGAGGTCAGCTCG -> GGGCGCGAGGTCAGCTCGG
GGGGCTCCTCGGTTAGCTT -> GGGCTCCTCGGTTAGCTTC
GGGTGGCTAATAGGTAGAA -> GGTGGCTAATAGGTAGAAA
GGGTTACTATCTGATGTTA -> GGTTACTATCTGATGTTAA
GGGTTACTGAATCGATCGA -> GGTTACTGAATCGATCGAT
GGTAACCGAGCACCTACGT -> GTAACCGAGCACCTACGTT
GGTACATCGAATATTCATA -> GTACATCGAATATTCATAA
GGTACTGAATCGATCGATC -> GTACTGAATCGATCGATCA
GGTAGAAAGCAATCCTTAG -> GTAGAAAGCAATCCTTAGA
GGTAGCGCCAGTCCACTAA -> GTAGCGCCAGTCCACTAAC
GGTAGGAGCTGGTATGATC -> GTAGGAGCTGGTATGATCC
GGTAGTTGTGTTGATAAAG -> GTAGTTGTGTTGATAAAGA
GGTATGATCCATGACATAC -> GTATGATCCATGACATACC
GGTATGCCTAGTAAGACTG -> GTATGCCTAGTAAGACTGG
GGTCAAGACTGTATAGCGA -> GTCAAGACTGTATAGCGAT
GGTCACTGACGATCACAAA -> GTCACTGACGATCACAAAG
GGTCAGCTCGGAAGTTATC -> GTCAGCTCGGAAGTTATCT
GGTGACACATCGGAAAGGA -> GTGACACATCGGAAAGGAA
GGTGAGCGTGGGCACCAGG -> GTGAGCGTGGGCACCAGGT
GGTGCATCGGCTACGACTT -> GTGCATCGGCTACGACTTC
GGTGGCTAATAGGTAGAAA -> GTGGCTAATAGGTAGAAAG
GGTGTGTAAACCCTGTCTG -> GTGTGTAAACCCTGTCTGC
GGTGTTTTAGTTACTTTTT -> GTGTTTTAGTTACTTTTTG
GGTTACTATCTGATGTTAA -> GTTACTATCTGATGTTAAA
GGTTACTGAATCGATCGAT -> GTTACTGAATCGATCGATC
GGTTAGCGGTGACACATCG -> GTTAGCGGTGACACATCGG
GGTTAGCTTCTTTTCGATT -> GTTAGCTTCTTTTCGATTC
GGTTATCTGGGGCGCGAGG -> GTTATCTGGGGCGCGAGGT
GGTTCGTCAGTTCCTTATG -> GTTCGTCAGTTCCTTATGG
GGTTGGCCCGTGGGGCGCC -> GTTGGCCCGTGGGGCGCCA
GGTTTAATAACGGATATAA -> GTTTAATAACGGATATAAA
GTAAACCCTGTCTGCAGCG -> TAAACCCTGTCTGCAGCGT
GTAAATTAATTGTACGCTA -> TAAATTAATTGTACGCTAC
GTAACCGAGCACCTACGTT -> TAACCGAGCACCTACGTTG
GTAACCTCCTGTAAGACAT -> TAACCTCCTGTAAGACATG
GTAACGCCTACTGAATCGA -> TAACGCCTACTGAATCGAT
GTAAGACATGATCATCGGA -> TAAGACATGATCATCGGAC
GTAAGACTGGCGCCGCACG -> TAAGACTGGCGCCGCACGG
GTAAGCTCATAGATTCGGC -> TAAGCTCATAGATTCGGCT
GTACATCGAATATTCATAA -> TACATCGAATATTCATAAG
GTACCTGCCTGCGGGTGGC -> TACCTGCCTGCGGGTGGCT
GTACGAAATGTGTGCTCGG -> TACGAAATGTGTGCTCGGG
GTACGCGCCGACCTACCTT -> TACGCGCCGACCTACCTTA
GTACGCTACGTACGAAATG -> TACGCTACGTACGAAATGT
GTACGTCTTAAGACAGCAA -> TACGTCTTAAGACAGCAAC
GTACGTGACGCGTTGCTAT -> TACGTGACGCGTTGCTATG
GTACTCCTGAGCCTTACGC -> TACTCCTGAGCCTTACGCC
GTACTGAATCGATCGATCA -> TACTGAATCGATCGATCAA
GTACTTAGAACAATTAAGA -> TACTTAGAACAATTAAGAG
GTAGAAAGCAATCCTTAGA -> TAGAAAGCAATCCTTAGAG
GTAGACTGCTGACACCACT -> TAGACTGCTGACACCACTG
GTAGCGCCAGTCCACTAAC -> TAGCGCCAGTCCACTAACT
GTAGCGGCGCCCTGGCTGC -> TAGCGGCGCCCTGGCTGCG
GTAGGAGCTGGTATGATCC -> TAGGAGCTGGTATGATCCA
GTAGGGAACCTCCATATCT -> TAGGGAACCTCCATATCTT
GTAGGGAGAAAAAAATCTG -> TAGGGAGAAAAAAATCTGA
GTAGTTGTGTTGATAAAGA -> TAGTTGTGTTGATAAAGAT
GTAGTTTATGCCGGTATGC -> TAGTTTATGCCGGTATGCC
GTAGTTTTCTTTTCAACCG -> TAGTTTTCTTTTCAACCGA
GTATAGCGATAACTCCATT -> TATAGCGATAACTCCATTC
GTATATCTTAGGATGTCAG -> TATATCTTAGGATGTCAGC
GTATCGATAACAGAAGGGG -> TATCGATAACAGAAGGGGC
GTATGACTGATTAGAAGCC -> TATGACTGATTAGAAGCCG
GTATGATCCATGACATACC -> TATGATCCATGACATACCC
GTATGCCTAGTAAGACTGG -> TATGCCTAGTAAGACTGGC
GTATGGGGATTGCAGTGTC -> TATGGGGATTGCAGTGTCG
GTATTGCGCGGACGCTCAA -> TATTGCGCGGACGCTCAAT
GTATTTCATTCGCACTTCC -> TATTTCATTCGCACTTCCG
GTCAAGACTGTATAGCGAT -> TCAAGACTGTATAGCGATA
GTCAATTCTTCTATCGCAG -> TCAATTCTTCTATCGCAGA
GTCAATTTAGTCAGTGTTG -> TCAATTTAGTCAGTGTTGT
GTCACATGCTAGTGCTTGG -> TCACATGCTAGTGCTTGGC
GTCACATTCACCTACATAT -> TCACATTCACCTACATATA
GTCACTGACGATCACAAAG -> TCACTGACGATCACAAAGT
GTCAGATGGTTGGCCCGTG -> TCAGATGGTTGGCCCGTGG
GTCAGCTCCACTATAATCG -> TCAGCTCCACTATAATCGT
GTCAGCTCGGAAGTTATCT -> TCAGCTCGGAAGTTATCTG
GTCAGGCGAGAGAATCGTT -> TCAGGCGAGAGAATCGTTG
GTCAGTGTTGTGTCAGGCG -> TCAGTGTTGTGTCAGGCGA
GTCAGTTCCTTATGGCTGA -> TCAGTTCCTTATGGCTGAG
GTCCACTAACTAAACCGTA -> TCCACTAACTAAACCGTAC
GTCGCTCCTGGTAGCGCCA -> TCGCTCCTGGTAGCGCCAG
GTCGCTTTTTGGTGAGCGT -> TCGCTTTTTGGTGAGCGTG
GTCGGGCGTTCTCGAGGCG -> TCGGGCGTTCTCGAGGCGG
GTCGTTGCCGTTCTACGCA -> TCGTTGCCGTTCTACGCAG
GTCTCAAGGTCAAGACTGT -> TCTCAAGGTCAAGACTGTA
GTCTCCCCTTGGAAGACCC -> TCTCCCCTTGGAAGACCCT
GTCTGCAGCGTATGGGGAT -> TCTGCAGCGTATGGGGATT
GTCTGTGTACTCCTGAGCC -> TCTGTGTACTCCTGAGCCT
GTCTTAAGACAGCAACCTG -> TCTTAAGACAGCAACCTGT
GTCTTCACCGGCTACTCGG -> TCTTCACCGGCTACTCGGT
GTCTTCCGCTTCAATTTGC -> TCTTCCGCTTCAATTTGCC
GTGAAGCAGGTTATCTGGG -> TGAAGCAGGTTATCTGGGG
GTGACACATCGGAAAGGAA -> TGACACATCGGAAAGGAAG
GTGACGACTAATTAAGTAG -> TGACGACTAATTAAGTAGA
GTGACGCGTTGCTATGACT -> TGACGCGTTGCTATGACTG
GTGAGCGTGGGCACCAGGT -> TGAGCGTGGGCACCAGGTA
GTGATGCGAGAACAAGATG -> TGATGCGAGAACAAGATGT
GTGCATCGGCTACGACTTC -> TGCATCGGCTACGACTTCA
GTGCGCGAGGTAGTTGTGT -> TGCGCGAGGTAGTTGTGTT
GTGCTATACTGGATCGTTT -> TGCTATACTGGATCGTTTT
GTGCTCGGGTTACTATCTG -> TGCTCGGGTTACTATCTGA
GTGCTTGGCAGTATTGCGC -> TGCTTGGCAGTATTGCGCG
GTGGAACGGGCAGTCAATT -> TGGAACGGGCAGTCAATTT
GTGGCTAATAGGTAGAAAG -> TGGCTAATAGGTAGAAAGC
GTGGGCACCAGGTAACCGA -> TGGGCACCAGGTAACCGAG
GTGGGGCGCCATAGACTGC -> TGGGGCGCCATAGACTGCT
GTGTAAACCCTGTCTGCAG -> TGTAAACCCTGTCTGCAGC
GTGTACGTGACGCGTTGCT -> TGTACGTGACGCGTTGCTA
GTGTACTCCTGAGCCTTAC -> TGTACTCCTGAGCCTTACG
GTGTCAGATGGTTGGCCCG -> TGTCAGATGGTTGGCCCGT
GTGTCAGGCGAGAGAATCG -> TGTCAGGCGAGAGAATCGT
GTGTCGCTTTTTGGTGAGC -> TGTCGCTTTTTGGTGAGCG
GTGTGCTCGGGTTACTATC -> TGTGCTCGGGTTACTATCT
GTGTGTAAACCCTGTCTGC -> TGTGTAAACCCTGTCTGCA
GTGTTGATAAAGATCAAAG -> TGTTGATAAAGATCAAAGA
GTGTTGTGTCAGGCGAGAG -> TGTTGTGTCAGGCGAGAGA
GTGTTTTAGTTACTTTTTG -> TGTTTTAGTTACTTTTTGT
GTTAAAACTGCGAGTAGTT -> TTAAAACTGCGAGTAGTTT
GTTACCGGCAGTCACATGC -> TTACCGGCAGTCACATGCT
GTTACTATCTGATGTTAAA -> TTACTATCTGATGTTAAAA
GTTACTGAATCGATCGATC -> TTACTGAATCGATCGATCA
GTTACTTTTTGTGATGCGA -> TTACTTTTTGTGATGCGAG
GTTAGCGGTGACACATCGG -> TTAGCGGTGACACATCGGA
GTTAGCTTCTTTTCGATTC -> TTAGCTTCTTTTCGATTCG
GTTATCTGATTAATATGCA -> TTATCTGATTAATATGCAG
GTTATCTGGGGCGCGAGGT -> TTATCTGGGGCGCGAGGTC
GTTCACTGAAGACCAACAA -> TTCACTGAAGACCAACAAA
GTTCATGCTTCACCACGAG -> TTCATGCTTCACCACGAGC
GTTCCGGCACTTCCCCCTG -> TTCCGGCACTTCCCCCTGA
GTTCCTTATGGCTGAGCGA -> TTCCTTATGGCTGAGCGAT
GTTCGGCAGGAGCCATCTG -> TTCGGCAGGAGCCATCTGA
GTTCGTCAGTTCCTTATGG -> TTCGTCAGTTCCTTATGGC
GTTCTACGCAGTTCCGGCA -> TTCTACGCAGTTCCGGCAC
GTTCTCGAGGCGGTCACTG -> TTCTCGAGGCGGTCACTGA
GTTGACGTAACCTCCTGTA -> TTGACGTAACCTCCTGTAA
GTTGATAAAGATCAAAGAA -> TTGATAAAGATCAAAGAAC
GTTGATCGTAAGCTCATAG -> TTGATCGTAAGCTCATAGA
GTTGCCGGTACATCGAATA -> TTGCCGGTACATCGAATAT
GTTGCCGTTCTACGCAGTT -> TTGCCGTTCTACGCAGTTC
GTTGCTATGACTGTGAAGC -> TTGCTATGACTGTGAAGCA
GTTGGCCCGTGGGGCGCCA -> TTGGCCCGTGGGGCGCCAT
GTTGTGTCAGGCGAGAGAA -> TTGTGTCAGGCGAGAGAAT
GTTGTGTTGATAAAGATCA -> TTGTGTTGATAAAGATCAA
GTTTAATAACGGATATAAA -> TTTAATAACGGATATAAAA
GTTTAGGTAGGAGCTGGTA -> TTTAGGTAGGAGCTGGTAT
GTTTATGCCGGTATGCCTA -> TTTATGCCGGTATGCCTAG
GTTTATTAGAGCTTTCCCA -> TTTATTAGAGCTTTCCCAC
GTTTTAGTTACTTTTTGTG -> TTTTAGTTACTTTTTGTGA
GTTTTCTTTTCAACCGAAA -> TTTTCTTTTCAACCGAAAC
GTTTTGCCGCGCTTTTTTC -> TTTTGCCGCGCTTTTTTCT
GTTTTTATTTACACTCATT -> TTTTTATTTACACTCATTT
TAAAACTGCGAGTAGTTTA -> AAAACTGCGAGTAGTTTAT
TAAAATCCGGATAGGCCCA -> AAAATCCGGATAGGCCCAC
TAAAATTGCCCTGGGCTTC -> AAAATTGCCCTGGGCTTCA
TAAACCCTGTCTGCAGCGT -> AAACCCTGTCTGCAGCGTA
TAAACCGTACGTCTTAAGA -> AAACCGTACGTCTTAAGAC
TAAAGATCAAAGAACTGGC -> AAAGATCAAAGAACTGGCA
TAAATTAATTGTACGCTAC -> AAATTAATTGTACGCTACG
TAACAGAAGGGGCTCCTCG -> AACAGAAGGGGCTCCTCGG
TAACCGAGCACCTACGTTG -> AACCGAGCACCTACGTTGA
TAACCTCCTGTAAGACATG -> AACCTCCTGTAAGACATGA
TAACGCCTACTGAATCGAT -> AACGCCTACTGAATCGATC
TAACGGATATAAAATCCGG -> AACGGATATAAAATCCGGA
TAACGGCATAGGGGCATTC -> AACGGCATAGGGGCATTCG
TAACGTACTTAGAACAATT -> AACGTACTTAGAACAATTA
TAACTAAACCGTACGTCTT -> AACTAAACCGTACGTCTTA
TAACTCCATTCGTTTATTA -> AACTCCATTCGTTTATTAG
TAAGACAGCAACCTGTAGC -> AAGACAGCAACCTGTAGCG
TAAGACATGATCATCGGAC -> AAGACATGATCATCGGACA
TAAGACTGGCGCCGCACGG -> AAGACTGGCGCCGCACGGA
TAAGAGTAGTTTTCTTTTC -> AAGAGTAGTTTTCTTTTCA
TAAGATAATTGAGCCCTAG -> AAGATAATTGAGCCCTAGT
TAAGCATCCTCTGATCCTG -> AAGCATCCTCTGATCCTGG
TAAGCTCATAGATTCGGCT -> AAGCTCATAGATTCGGCTT
TAAGTAGACTGCTGACACC -> AAGTAGACTGCTGACACCA
TAAGTCGCTCCTGGTAGCG -> AAGTCGCTCCTGGTAGCGC
TAATAACGGATATAAAATC -> AATAACGGATATAAAATCC
TAATAGGTAGAAAGCAATC -> AATAGGTAGAAAGCAATCC
TAATATGCAGGTGCATCGG -> AATATGCAGGTGCATCGGC
TAATCGTCGGGCGTTCTCG -> AATCGTCGGGCGTTCTCGA
TAATTAAGTAGACTGCTGA -> AATTAAGTAGACTGCTGAC
TAATTGAGCCCTAGTATTT -> AATTGAGCCCTAGTATTTC
TAATTGTACGCTACGTACG -> AATTGTACGCTACGTACGA
TACAATGCTTGCAAACTAG -> ACAATGCTTGCAAACTAGA
TACACGTACGCGCCGACCT -> ACACGTACGCGCCGACCTA
TACACTCATTTCTCAGACA -> ACACTCATTTCTCAGACAC
TACATATATAACGGCATAG -> ACATATATAACGGCATAGG
TACATCGAATATTCATAAG -> ACATCGAATATTCATAAGT
TACATGTTTTTATTTACAC -> ACATGTTTTTATTTACACT
TACCAGCAGCACGTCTCAA -> ACCAGCAGCACGTCTCAAG
TACCCCTTTCCCTAACGTA -> ACCCCTTTCCCTAACGTAC
TACCCGATCTATGGCGTTC -> ACCCGATCTATGGCGTTCA
TACCGGCAGTCACATGCTA -> ACCGGCAGTCACATGCTAG
TACCTGCCTGCGGGTGGCT -> ACCTGCCTGCGGGTGGCTA
TACCTTACTTCCCGCGTGT -> ACCTTACTTCCCGCGTGTC
TACGAAATGTGTGCTCGGG -> ACGAAATGTGTGCTCGGGT
TACGACTTCACAAGCGAAT -> ACGACTTCACAAGCGAATT
TACGCAGTTCCGGCACTTC -> ACGCAGTTCCGGCACTTCC
TACGCCTCGACGTATCGAT -> ACGCCTCGACGTATCGATA
TACGCGCCGACCTACCTTA -> ACGCGCCGACCTACCTTAC
TACGCTACGTACGAAATGT -> ACGCTACGTACGAAATGTG
TACGTACGAAATGTGTGCT -> ACGTACGAAATGTGTGCTC
TACGTAGGGAGAAAAAAAT -> ACGTAGGGAGAAAAAAATC
TACGTCTTAAGACAGCAAC -> ACGTCTTAAGACAGCAACC
TACGTGACGCGTTGCTATG -> ACGTGACGCGTTGCTATGA
TACGTGCGCGAGGTAGTTG -> ACGTGCGCGAGGTAGTTGT
TACGTTGATCGTAAGCTCA -> ACGTTGATCGTAAGCTCAT
TACTATCTGATGTTAAAAC -> ACTATCTGATGTTAAAACT
TACTCCTGAGCCTTACGCC -> ACTCCTGAGCCTTACGCCT
TACTCGGTTCGTCAGTTCC -> ACTCGGTTCGTCAGTTCCT
TACTGAATCGATCGATCAA -> ACTGAATCGATCGATCAAC,ACTGAATCGATCGATCAAC,ACTGAATCGATCGATCAAA,ACTGAATCGATCGATCAAT
TACTGGATCGTTTTGCCGC -> ACTGGATCGTTTTGCCGCG
TACTTAGAACAATTAAGAG -> ACTTAGAACAATTAAGAGT
TACTTCCCGCGTGTCAGAT -> ACTTCCCGCGTGTCAGATG
TACTTTTTGTGATGCGAGA -> ACTTTTTGTGATGCGAGAA
TAGAAAGCAATCCTTAGAG -> AGAAAGCAATCCTTAGAGG
TAGAAAGTATATCTTAGGA -> AGAAAGTATATCTTAGGAT
TAGAACAATTAAGAGTAGT -> AGAACAATTAAGAGTAGTT
TAGAAGCCGGCACATCTTG -> AGAAGCCGGCACATCTTGC
TAGAATGCTACAATGCTTG -> AGAATGCTACAATGCTTGC
TAGACTGCTGACACCACTA -> AGACTGCTGACACCACTAT
TAGACTGCTGACACCACTC -> AGACTGCTGACACCACTCC
TAGACTGCTGACACCACTG -> AGACTGCTGACACCACTGC
TAGACTGCTGACACCACTT -> AGACTGCTGACACCACTTC
TAGAGCTTTCCCACAAAAT -> AGAGCTTTCCCACAAAATC
TAGAGGCTGACCCTCAGTT -> AGAGGCTGACCCTCAGTTG
TAGAGGGCCTTCTTATCCT -> AGAGGGCCTTCTTATCCTT
TAGATTCGGCTTCCAGATA -> AGATTCGGCTTCCAGATAG
TAGCGATAACTCCATTCGT -> AGCGATAACTCCATTCGTT
TAGCGCCAGTCCACTAACT -> AGCGCCAGTCCACTAACTA
TAGCGGCGCCCTGGCTGCG -> AGCGGCGCCCTGGCTGCGA
TAGCGGTGACACATCGGAA -> AGCGGTGACACATCGGAAA
TAGCTTCTTTTCGATTCGG -> AGCTTCTTTTCGATTCGGA
TAGGAGCTGGTATGATCCA -> AGGAGCTGGTATGATCCAT
TAGGATGTCAGCTCCACTA -> AGGATGTCAGCTCCACTAT
TAGGCCCACTTCAATTTCG -> AGGCCCACTTCAATTTCGT
TAGGGAACCTCCATATCTT -> AGGGAACCTCCATATCTTT
TAGGGAGAAAAAAATCTGA -> AGGGAGAAAAAAATCTGAA
TAGGGGCATTCGCCTACCC -> AGGGGCATTCGCCTACCCG
TAGGTAGAAAGCAATCCTT -> AGGTAGAAAGCAATCCTTA
TAGGTAGGAGCTGGTATGA -> AGGTAGGAGCTGGTATGAT
TAGTAAGACTGGCGCCGCA -> AGTAAGACTGGCGCCGCAC
TAGTATTTCATTCGCACTT -> AGTATTTCATTCGCACTTC
TAGTCAGTGTTGTGTCAGG -> AGTCAGTGTTGTGTCAGGC
TAGTGCTTGGCAGTATTGC -> AGTGCTTGGCAGTATTGCG
TAGTTACTTTTTGTGATGC -> AGTTACTTTTTGTGATGCG
TAGTTCACTGAAGACCAAC -> AGTTCACTGAAGACCAACA
TAGTTGTGTTGATAAAGAT -> AGTTGTGTTGATAAAGATC
TAGTTTAGGTAGGAGCTGG -> AGTTTAGGTAGGAGCTGGT
TAGTTTATGCCGGTATGCC -> AGTTTATGCCGGTATGCCT
TAGTTTTCTTTTCAACCGA -> AGTTTTCTTTTCAACCGAA
TATAAAATCCGGATAGGCC -> ATAAAATCCGGATAGGCCC
TATAACGGCATAGGGGCAT -> ATAACGGCATAGGGGCATT
TATAATCGTCGGGCGTTCT -> ATAATCGTCGGGCGTTCTC
TATACTGGATCGTTTTGCC -> ATACTGGATCGTTTTGCCG
TATAGCGATAACTCCATTC -> ATAGCGATAACTCCATTCG
TATATAACGGCATAGGGGC -> ATATAACGGCATAGGGGCA
TATATCTTAGGATGTCAGC -> ATATCTTAGGATGTCAGCT
TATCAGATGGAGACTCATA -> ATCAGATGGAGACTCATAA
TATCCTTGGAGGCAAGCGA -> ATCCTTGGAGGCAAGCGAG
TATCGATAACAGAAGGGGC -> ATCGATAACAGAAGGGGCT
TATCGCAGAATTGACCTCA -> ATCGCAGAATTGACCTCAA
TATCGCTGTCAATTCTTCT -> ATCGCTGTCAATTCTTCTA
TATCGGGCTCGTACCTGCC -> ATCGGGCTCGTACCTGCCT
TATCTGATGTTAAAACTGC -> ATCTGATGTTAAAACTGCG
TATCTGATTAATATGCAGG -> ATCTGATTAATATGCAGGT
TATCTGATTGGTTAGCGGT -> ATCTGATTGGTTAGCGGTG
TATCTGGGGCGCGAGGTCA -> ATCTGGGGCGCGAGGTCAG
TATCTTAGGATGTCAGCTC -> ATCTTAGGATGTCAGCTCC
TATCTTTAAGATAATTGAG -> ATCTTTAAGATAATTGAGC
TATGACTGATTAGAAGCCG -> ATGACTGATTAGAAGCCGG
TATGACTGTGAAGCAGGTT -> ATGACTGTGAAGCAGGTTA
TATGATCCATGACATACCC -> ATGATCCATGACATACCCC
TATGCAGGTGCATCGGCTA -> ATGCAGGTGCATCGGCTAC
TATGCCGGTATGCCTAGTA -> ATGCCGGTATGCCTAGTAA
TATGCCTAGTAAGACTGGC -> ATGCCTAGTAAGACTGGCG
TATGGCGTTCATGCTTCAC -> ATGGCGTTCATGCTTCACC
TATGGCTGAGCGATTCACA -> ATGGCTGAGCGATTCACAG
TATGGGGATTGCAGTGTCG -> ATGGGGATTGCAGTGTCGC
TATTAGAGCTTTCCCACAA -> ATTAGAGCTTTCCCACAAA
TATTCATAAGTCGCTCCTG -> ATTCATAAGTCGCTCCTGG
TATTCCAAAACCTACTGAA -> ATTCCAAAACCTACTGAAT
TATTGAAATCTTCAGCTAG -> ATTGAAATCTTCAGCTAGA
TATTGCGCGGACGCTCAAT -> ATTGCGCGGACGCTCAATG
TATTTACACTCATTTCTCA -> ATTTACACTCATTTCTCAG
TATTTACGTGCGCGAGGTA -> ATTTACGTGCGCGAGGTAG
TATTTCATTCGCACTTCCG -> ATTTCATTCGCACTTCCGA
TCAAAGAACTGGCATTGCC -> CAAAGAACTGGCATTGCCA
TCAAATTATCTGATTGGTT -> CAAATTATCTGATTGGTTA
TCAACCCACAAACTATTGA -> CAACCCACAAACTATTGAA
TCAACCGAAACCAGGCTCT -> CAACCGAAACCAGGCTCTT
TCAACCTAGACTGCTGACA -> CAACCTAGACTGCTGACAC
TCAACGAGAAGAGGTGTGT -> CAACGAGAAGAGGTGTGTA
TCAACTCATGAGAAGTCTG -> CAACTCATGAGAAGTCTGT
TCAAGACTGTATAGCGATA -> CAAGACTGTATAGCGATAA
TCAAGGTCAAGACTGTATA -> CAAGGTCAAGACTGTATAG
TCAATATCGCTGTCAATTC -> CAATATCGCTGTCAATTCT
TCAATGACGTAGGGAACCT -> CAATGACGTAGGGAACCTC
TCAATTCTTCTATCGCAGA -> CAATTCTTCTATCGCAGAA
TCAATTTAGTCAGTGTTGT -> CAATTTAGTCAGTGTTGTG
TCAATTTCGTGGAACGGGC -> CAATTTCGTGGAACGGGCA
TCAATTTGCCTAGTTCACT -> CAATTTGCCTAGTTCACTG
TCACAAAGTCTTCCGCTTC -> CACAAAGTCTTCCGCTTCA
TCACAAGCGAATTCCAAGT -> CACAAGCGAATTCCAAGTG
TCACAGCCAGTCTCCCCTT -> CACAGCCAGTCTCCCCTTG
TCACATGCTAGTGCTTGGC -> CACATGCTAGTGCTTGGCA
TCACATTCACCTACATATA -> CACATTCACCTACATATAT
TCACCACGAGCTCTGCATA -> CACCACGAGCTCTGCATAC
TCACCGGCTACTCGGTTCG -> CACCGGCTACTCGGTTCGT
TCACCTACATATATAACGG -> CACCTACATATATAACGGC
TCACTGAAGACCAACAAAA -> CACTGAAGACCAACAAAAC
TCACTGACGATCACAAAGT -> CACTGACGATCACAAAGTC
TCAGACACGGCTGTGCTAT -> CAGACACGGCTGTGCTATA
TCAGATGGAGACTCATAAG -> CAGATGGAGACTCATAAGC
TCAGATGGTTGGCCCGTGG -> CAGATGGTTGGCCCGTGGG
TCAGCTAGAATGCTACAAT -> CAGCTAGAATGCTACAATG
TCAGCTCCACTATAATCGT -> CAGCTCCACTATAATCGTC
TCAGCTCGGAAGTTATCTG -> CAGCTCGGAAGTTATCTGA
TCAGGCGAGAGAATCGTTG -> CAGGCGAGAGAATCGTTGC
TCAGTGTTGTGTCAGGCGA -> CAGTGTTGTGTCAGGCGAG
TCAGTTCCTTATGGCTGAG -> CAGTTCCTTATGGCTGAGC
TCAGTTGACGTAACCTCCT -> CAGTTGACGTAACCTCCTG
TCATAAGCATCCTCTGATC -> CATAAGCATCCTCTGATCC
TCATAAGTCGCTCCTGGTA -> CATAAGTCGCTCCTGGTAG
TCATACACGTACGCGCCGA -> CATACACGTACGCGCCGAC
TCATAGATTCGGCTTCCAG -> CATAGATTCGGCTTCCAGA
TCATCGGACACTCGTCGTT -> CATCGGACACTCGTCGTTG
TCATGAGAAGTCTGTGTAC -> CATGAGAAGTCTGTGTACT
TCATGCTTCACCACGAGCT -> CATGCTTCACCACGAGCTC
TCATTCGCACTTCCGAACA -> CATTCGCACTTCCGAACAA
TCATTTCTCAGACACGGCT -> CATTTCTCAGACACGGCTG
TCCAAAACCTACTGAATCG -> CCAAAACCTACTGAATCGA
TCCAAGTGACGACTAATTA -> CCAAGTGACGACTAATTAA
TCCACTAACTAAACCGTAC -> CCACTAACTAAACCGTACG
TCCACTATAATCGTCGGGC -> CCACTATAATCGTCGGGCG
TCCAGATAGAAAGTATATC -> CCAGATAGAAAGTATATCT
TCCAGGTACTGAATCGATC -> CCAGGTACTGAATCGATCG
TCCAGTAACGCCTACTGAA -> CCAGTAACGCCTACTGAAT
TCCATATCTTTAAGATAAT -> CCATATCTTTAAGATAATT
TCCATGACATACCCCTTTC -> CCATGACATACCCCTTTCC
TCCATTCGTTTATTAGAGC -> CCATTCGTTTATTAGAGCT
TCCCACAAAATCCCGAGGA -> CCCACAAAATCCCGAGGAG
TCCCCCTGAGGACTGGTTT -> CCCCCTGAGGACTGGTTTA
TCCCCTTGGAAGACCCTTC -> CCCCTTGGAAGACCCTTCA
TCCCGAGGAGCCGCGCCAG -> CCCGAGGAGCCGCGCCAGA
TCCCGCGTGTCAGATGGTT -> CCCGCGTGTCAGATGGTTG
TCCCTAACGTACTTAGAAC -> CCCTAACGTACTTAGAACA
TCCGAACAATCGACCAAGC -> CCGAACAATCGACCAAGCT
TCCGCTCCAGGTACTGAAT -> CCGCTCCAGGTACTGAATC
TCCGCTTCAATTTGCCTAG -> CCGCTTCAATTTGCCTAGT
TCCGGATAGGCCCACTTCA -> CCGGATAGGCCCACTTCAA
TCCGGCACTTCCCCCTGAG -> CCGGCACTTCCCCCTGAGG
TCCTCGGTTAGCTTCTTTT -> CCTCGGTTAGCTTCTTTTC
TCCTCTGATCCTGGCCGAC -> CCTCTGATCCTGGCCGACA
TCCTGAGCCTTACGCCTCG -> CCTGAGCCTTACGCCTCGA
TCCTGGCCGACACCTTTAC -> CCTGGCCGACACCTTTACC
TCCTGGTAGCGCCAGTCCA -> CCTGGTAGCGCCAGTCCAC
TCCTGTAAGACATGATCAT -> CCTGTAAGACATGATCATC
TCCTTAGAGGCTGACCCTC -> CCTTAGAGGCTGACCCTCA
TCCTTATGGCTGAGCGATT -> CCTTATGGCTGAGCGATTC
TCCTTGGAGGCAAGCGAGG -> CCTTGGAGGCAAGCGAGGG
TCGAATATTCATAAGTCGC -> CGAATATTCATAAGTCGCT
TCGACGTATCGATAACAGA -> CGACGTATCGATAACAGAA
TCGAGGCGGTCACTGACGA -> CGAGGCGGTCACTGACGAT
TCGATAACAGAAGGGGCTC -> CGATAACAGAAGGGGCTCC
TCGATCAAATTATCTGATT -> CGATCAAATTATCTGATTG
TCGATCAACCCACAAACTA -> CGATCAACCCACAAACTAT
TCGATCAACTCATGAGAAG -> CGATCAACTCATGAGAAGT
TCGATCAATATCGCTGTCA -> CGATCAATATCGCTGTCAA
TCGATCGATCAAATTATCT -> CGATCGATCAAATTATCTG
TCGATCGATCAACCCACAA -> CGATCGATCAACCCACAAA
TCGATCGATCAACTCATGA -> CGATCGATCAACTCATGAG
TCGATCGATCAATATCGCT -> CGATCGATCAATATCGCTG
TCGATTCGGATATCGGGCT -> CGATTCGGATATCGGGCTC
TCGCACTTCCGAACAATCG -> CGCACTTCCGAACAATCGA
TCGCAGAATTGACCTCAAC -> CGCAGAATTGACCTCAACG
TCGCCTACCCGATCTATGG -> CGCCTACCCGATCTATGGC
TCGCGTATGACTGATTAGA -> CGCGTATGACTGATTAGAA
TCGCTCCTGGTAGCGCCAG -> CGCTCCTGGTAGCGCCAGT
TCGCTGTCAATTCTTCTAT -> CGCTGTCAATTCTTCTATC
TCGCTTTTTGGTGAGCGTG -> CGCTTTTTGGTGAGCGTGG
TCGGAAAGGAAGTGTACGT -> CGGAAAGGAAGTGTACGTG
TCGGAAGTTATCTGATTAA -> CGGAAGTTATCTGATTAAT
TCGGACACTCGTCGTTGCC -> CGGACACTCGTCGTTGCCG
TCGGATATCGGGCTCGTAC -> CGGATATCGGGCTCGTACC
TCGGCAGGAGCCATCTGAT -> CGGCAGGAGCCATCTGATA
TCGGCTACGACTTCACAAG -> CGGCTACGACTTCACAAGC
TCGGCTTCCAGATAGAAAG -> CGGCTTCCAGATAGAAAGT
TCGGCTTCGCGTATGACTG -> CGGCTTCGCGTATGACTGA
TCGGGCGTTCTCGAGGCGG -> CGGGCGTTCTCGAGGCGGT
TCGGGCTCGTACCTGCCTG -> CGGGCTCGTACCTGCCTGC
TCGGGTTACTATCTGATGT -> CGGGTTACTATCTGATGTT
TCGGTTAGCTTCTTTTCGA -> CGGTTAGCTTCTTTTCGAT
TCGGTTCGTCAGTTCCTTA -> CGGTTCGTCAGTTCCTTAT
TCGTAAGCTCATAGATTCG -> CGTAAGCTCATAGATTCGG
TCGTACCTGCCTGCGGGTG -> CGTACCTGCCTGCGGGTGG
TCGTCAGTTCCTTATGGCT -> CGTCAGTTCCTTATGGCTG
TCGTCGGGCGTTCTCGAGG -> CGTCGGGCGTTCTCGAGGC
TCGTCGTTGCCGTTCTACG -> CGTCGTTGCCGTTCTACGC
TCGTGGAACGGGCAGTCAA -> CGTGGAACGGGCAGTCAAT
TCGTTGCCGGTACATCGAA -> CGTTGCCGGTACATCGAAT
TCGTTGCCGTTCTACGCAG -> CGTTGCCGTTCTACGCAGT
TCGTTTATTAGAGCTTTCC -> CGTTTATTAGAGCTTTCCC
TCGTTTTGCCGCGCTTTTT -> CGTTTTGCCGCGCTTTTTT
TCTACGCAGTTCCGGCACT -> CTACGCAGTTCCGGCACTT
TCTAGTTTAGGTAGGAGCT -> CTAGTTTAGGTAGGAGCTG
TCTATCGCAGAATTGACCT -> CTATCGCAGAATTGACCTC
TCTATGGCGTTCATGCTTC -> CTATGGCGTTCATGCTTCA
TCTCAAGGTCAAGACTGTA -> CTCAAGGTCAAGACTGTAT
TCTCAGACACGGCTGTGCT -> CTCAGACACGGCTGTGCTA
TCTCCCCTTGGAAGACCCT -> CTCCCCTTGGAAGACCCTT
TCTCGAGGCGGTCACTGAC -> CTCGAGGCGGTCACTGACG
TCTGAACACGTAAATTAAT -> CTGAACACGTAAATTAATT
TCTGATATTTACGTGCGCG -> CTGATATTTACGTGCGCGA
TCTGATCCTGGCCGACACC -> CTGATCCTGGCCGACACCT
TCTGATGTTAAAACTGCGA -> CTGATGTTAAAACTGCGAG
TCTGATTAATATGCAGGTG -> CTGATTAATATGCAGGTGC
TCTGATTGGTTAGCGGTGA -> CTGATTGGTTAGCGGTGAC
TCTGCAGCGTATGGGGATT -> CTGCAGCGTATGGGGATTG
TCTGCATACATGTTTTTAT -> CTGCATACATGTTTTTATT
TCTGGGGCGCGAGGTCAGC -> CTGGGGCGCGAGGTCAGCT
TCTGTGTACTCCTGAGCCT -> CTGTGTACTCCTGAGCCTT
TCTTAAGACAGCAACCTGT -> CTTAAGACAGCAACCTGTA
TCTTAGGATGTCAGCTCCA -> CTTAGGATGTCAGCTCCAC
TCTTATCCTTGGAGGCAAG -> CTTATCCTTGGAGGCAAGC
TCTTCACCGGCTACTCGGT -> CTTCACCGGCTACTCGGTT
TCTTCAGCTAGAATGCTAC -> CTTCAGCTAGAATGCTACA
TCTTCCGCTTCAATTTGCC -> CTTCCGCTTCAATTTGCCT
TCTTCTATCGCAGAATTGA -> CTTCTATCGCAGAATTGAC
TCTTGCATAAAATTGCCCT -> CTTGCATAAAATTGCCCTG
TCTTGTCTTCACCGGCTAC -> CTTGTCTTCACCGGCTACT
TCTTTAAGATAATTGAGCC -> CTTTAAGATAATTGAGCCC
TCTTTAGACTGCTGACACC -> CTTTAGACTGCTGACACCA
TCTTTTCAACCGAAACCAG -> CTTTTCAACCGAAACCAGG
TCTTTTCGATTCGGATATC -> CTTTTCGATTCGGATATCG
TGAAATCTTCAGCTAGAAT -> GAAATCTTCAGCTAGAATG
TGAACACGTAAATTAATTG -> GAACACGTAAATTAATTGT
TGAAGACCAACAAAACCGC -> GAAGACCAACAAAACCGCG
TGAAGCAGGTTATCTGGGG -> GAAGCAGGTTATCTGGGGC
TGAATCGATCGATCAAATT -> GAATCGATCGATCAAATTA
TGAATCGATCGATCAACCC -> GAATCGATCGATCAACCCA
TGAATCGATCGATCAACTC -> GAATCGATCGATCAACTCA
TGAATCGATCGATCAATAT -> GAATCGATCGATCAATATC
TGACACATCGGAAAGGAAG -> GACACATCGGAAAGGAAGT
TGACACCACTATTCCAAAA -> GACACCACTATTCCAAAAC
TGACACCACTCCAGTAACG -> GACACCACTCCAGTAACGC
TGACACCACTGCAACTTGG -> GACACCACTGCAACTTGGG
TGACACCACTTCCGCTCCA -> GACACCACTTCCGCTCCAG
TGACAGATGATGATTGTTA -> GACAGATGATGATTGTTAC
TGACATACCCCTTTCCCTA -> GACATACCCCTTTCCCTAA
TGACCCTCAGTTGACGTAA -> GACCCTCAGTTGACGTAAC
TGACCTCAACGAGAAGAGG -> GACCTCAACGAGAAGAGGT
TGACGACTAATTAAGTAGA -> GACGACTAATTAAGTAGAC
TGACGATCACAAAGTCTTC -> GACGATCACAAAGTCTTCC
TGACGCGTTGCTATGACTG -> GACGCGTTGCTATGACTGT
TGACGTAACCTCCTGTAAG -> GACGTAACCTCCTGTAAGA
TGACGTAGGGAACCTCCAT -> GACGTAGGGAACCTCCATA
TGACTGATTAGAAGCCGGC -> GACTGATTAGAAGCCGGCA
TGACTGTGAAGCAGGTTAT -> GACTGTGAAGCAGGTTATC
TGAGAAGTCTGTGTACTCC -> GAGAAGTCTGTGTACTCCT
TGAGCCCTAGTATTTCATT -> GAGCCCTAGTATTTCATTC
TGAGCCTTACGCCTCGACG -> GAGCCTTACGCCTCGACGT
TGAGCGATTCACAGCCAGT -> GAGCGATTCACAGCCAGTC
TGAGCGTGGGCACCAGGTA -> GAGCGTGGGCACCAGGTAA
TGAGGACTGGTTTAATAAC -> GAGGACTGGTTTAATAACG
TGATAAAGATCAAAGAACT -> GATAAAGATCAAAGAACTG
TGATATTTACGTGCGCGAG -> GATATTTACGTGCGCGAGG
TGATCATCGGACACTCGTC -> GATCATCGGACACTCGTCG
TGATCCATGACATACCCCT -> GATCCATGACATACCCCTT
TGATCCTGGCCGACACCTT -> GATCCTGGCCGACACCTTT
TGATCGTAAGCTCATAGAT -> GATCGTAAGCTCATAGATT
TGATGATTGTTACCGGCAG -> GATGATTGTTACCGGCAGT
TGATGCGAGAACAAGATGT -> GATGCGAGAACAAGATGTT
TGATGTTAAAACTGCGAGT -> GATGTTAAAACTGCGAGTA
TGATTAATATGCAGGTGCA -> GATTAATATGCAGGTGCAT
TGATTAGAAGCCGGCACAT -> GATTAGAAGCCGGCACATC
TGATTGGTTAGCGGTGACA -> GATTGGTTAGCGGTGACAC
TGATTGTTACCGGCAGTCA -> GATTGTTACCGGCAGTCAC
TGCAAACTAGAGGGCCTTC -> GCAAACTAGAGGGCCTTCT
TGCAACTTGGGTTACTGAA -> GCAACTTGGGTTACTGAAT
TGCAGCGTATGGGGATTGC -> GCAGCGTATGGGGATTGCA
TGCAGGTGCATCGGCTACG -> GCAGGTGCATCGGCTACGA
TGCAGTGTCGCTTTTTGGT -> GCAGTGTCGCTTTTTGGTG
TGCATAAAATTGCCCTGGG -> GCATAAAATTGCCCTGGGC
TGCATACATGTTTTTATTT -> GCATACATGTTTTTATTTA
TGCATCGGCTACGACTTCA -> GCATCGGCTACGACTTCAC
TGCCATGTCACATTCACCT -> GCCATGTCACATTCACCTA
TGCCCTGGGCTTCAACCTA -> GCCCTGGGCTTCAACCTAG
TGCCGCGCTTTTTTCTAGT -> GCCGCGCTTTTTTCTAGTT
TGCCGGTACATCGAATATT -> GCCGGTACATCGAATATTC
TGCCGGTATGCCTAGTAAG -> GCCGGTATGCCTAGTAAGA
TGCCGTTCTACGCAGTTCC -> GCCGTTCTACGCAGTTCCG
TGCCTAGTAAGACTGGCGC -> GCCTAGTAAGACTGGCGCC
TGCCTAGTTCACTGAAGAC -> GCCTAGTTCACTGAAGACC
TGCCTGCGGGTGGCTAATA -> GCCTGCGGGTGGCTAATAG
TGCGACCCCTTGGTGTTTT -> GCGACCCCTTGGTGTTTTA
TGCGAGAACAAGATGTTCG -> GCGAGAACAAGATGTTCGG
TGCGAGTAGTTTATGCCGG -> GCGAGTAGTTTATGCCGGT
TGCGCGAGGTAGTTGTGTT -> GCGCGAGGTAGTTGTGTTG
TGCGCGGACGCTCAATGAC -> GCGCGGACGCTCAATGACG
TGCGGGTGGCTAATAGGTA -> GCGGGTGGCTAATAGGTAG
TGCTACAATGCTTGCAAAC -> GCTACAATGCTTGCAAACT
TGCTAGTGCTTGGCAGTAT -> GCTAGTGCTTGGCAGTATT
TGCTATACTGGATCGTTTT -> GCTATACTGGATCGTTTTG
TGCTATGACTGTGAAGCAG -> GCTATGACTGTGAAGCAGG
TGCTCGGGTTACTATCTGA -> GCTCGGGTTACTATCTGAT
TGCTGACACCACTATTCCA -> GCTGACACCACTATTCCAA
TGCTGACACCACTCCAGTA -> GCTGACACCACTCCAGTAA
TGCTGACACCACTGCAACT -> GCTGACACCACTGCAACTT
TGCTGACACCACTTCCGCT -> GCTGACACCACTTCCGCTC
TGCTTCACCACGAGCTCTG -> GCTTCACCACGAGCTCTGC
TGCTTGCAAACTAGAGGGC -> GCTTGCAAACTAGAGGGCC
TGCTTGGCAGTATTGCGCG -> GCTTGGCAGTATTGCGCGG
TGGAACGGGCAGTCAATTT -> GGAACGGGCAGTCAATTTA
TGGAAGACCCTTCATACAC -> GGAAGACCCTTCATACACG
TGGAGACTCATAAGCATCC -> GGAGACTCATAAGCATCCT
TGGAGGCAAGCGAGGGCAC -> GGAGGCAAGCGAGGGCACT
TGGATCGTTTTGCCGCGCT -> GGATCGTTTTGCCGCGCTT
TGGCAGTATTGCGCGGACG -> GGCAGTATTGCGCGGACGC
TGGCATTGCCATGTCACAT -> GGCATTGCCATGTCACATT
TGGCCCGTGGGGCGCCATA -> GGCCCGTGGGGCGCCATAG
TGGCCGACACCTTTACCAG -> GGCCGACACCTTTACCAGC
TGGCGCCGCACGGACAAGA -> GGCGCCGCACGGACAAGAT
TGGCGTTCATGCTTCACCA -> GGCGTTCATGCTTCACCAC
TGGCTAATAGGTAGAAAGC -> GGCTAATAGGTAGAAAGCA
TGGCTGAGCGATTCACAGC -> GGCTGAGCGATTCACAGCC
TGGCTGCGACCCCTTGGTG -> GGCTGCGACCCCTTGGTGT
TGGGCACCAGGTAACCGAG -> GGGCACCAGGTAACCGAGC
TGGGCTTCAACCTAGACTG -> GGGCTTCAACCTAGACTGC
TGGGGATTGCAGTGTCGCT -> GGGGATTGCAGTGTCGCTT
TGGGGCGCCATAGACTGCT -> GGGGCGCCATAGACTGCTG
TGGGGCGCGAGGTCAGCTC -> GGGGCGCGAGGTCAGCTCG
TGGGTTACTGAATCGATCG -> GGGTTACTGAATCGATCGA
TGGTAGCGCCAGTCCACTA -> GGTAGCGCCAGTCCACTAA
TGGTATGATCCATGACATA -> GGTATGATCCATGACATAC
TGGTGAGCGTGGGCACCAG -> GGTGAGCGTGGGCACCAGG
TGGTGTTTTAGTTACTTTT -> GGTGTTTTAGTTACTTTTT
TGGTTAGCGGTGACACATC -> GGTTAGCGGTGACACATCG
TGGTTGGCCCGTGGGGCGC -> GGTTGGCCCGTGGGGCGCC
TGGTTTAATAACGGATATA -> GGTTTAATAACGGATATAA
TGTAAACCCTGTCTGCAGC -> GTAAACCCTGTCTGCAGCG
TGTAAGACATGATCATCGG -> GTAAGACATGATCATCGGA
TGTACGCTACGTACGAAAT -> GTACGCTACGTACGAAATG
TGTACGTGACGCGTTGCTA -> GTACGTGACGCGTTGCTAT
TGTACTCCTGAGCCTTACG -> GTACTCCTGAGCCTTACGC
TGTAGCGGCGCCCTGGCTG -> GTAGCGGCGCCCTGGCTGC
TGTATAGCGATAACTCCAT -> GTATAGCGATAACTCCATT
TGTCAATTCTTCTATCGCA -> GTCAATTCTTCTATCGCAG
TGTCACATTCACCTACATA -> GTCACATTCACCTACATAT
TGTCAGATGGTTGGCCCGT -> GTCAGATGGTTGGCCCGTG
TGTCAGCTCCACTATAATC -> GTCAGCTCCACTATAATCG
TGTCAGGCGAGAGAATCGT -> GTCAGGCGAGAGAATCGTT
TGTCGCTTTTTGGTGAGCG -> GTCGCTTTTTGGTGAGCGT
TGTCTGCAGCGTATGGGGA -> GTCTGCAGCGTATGGGGAT
TGTCTTCACCGGCTACTCG -> GTCTTCACCGGCTACTCGG
TGTGAAGCAGGTTATCTGG -> GTGAAGCAGGTTATCTGGG
TGTGATGCGAGAACAAGAT -> GTGATGCGAGAACAAGATG
TGTGCTATACTGGATCGTT -> GTGCTATACTGGATCGTTT
TGTGCTCGGGTTACTATCT -> GTGCTCGGGTTACTATCTG
TGTGTAAACCCTGTCTGCA -> GTGTAAACCCTGTCTGCAG
TGTGTACTCCTGAGCCTTA -> GTGTACTCCTGAGCCTTAC
TGTGTCAGGCGAGAGAATC -> GTGTCAGGCGAGAGAATCG
TGTGTGCTCGGGTTACTAT -> GTGTGCTCGGGTTACTATC
TGTGTTGATAAAGATCAAA -> GTGTTGATAAAGATCAAAG
TGTTAAAACTGCGAGTAGT -> GTTAAAACTGCGAGTAGTT
TGTTACCGGCAGTCACATG -> GTTACCGGCAGTCACATGC
TGTTCGGCAGGAGCCATCT -> GTTCGGCAGGAGCCATCTG
TGTTGATAAAGATCAAAGA -> GTTGATAAAGATCAAAGAA
TGTTGTGTCAGGCGAGAGA -> GTTGTGTCAGGCGAGAGAA
TGTTTTAGTTACTTTTTGT -> GTTTTAGTTACTTTTTGTG
TGTTTTTATTTACACTCAT -> GTTTTTATTTACACTCATT
TTAAAACTGCGAGTAGTTT -> TAAAACTGCGAGTAGTTTA
TTAAGACAGCAACCTGTAG -> TAAGACAGCAACCTGTAGC
TTAAGAGTAGTTTTCTTTT -> TAAGAGTAGTTTTCTTTTC
TTAAGATAATTGAGCCCTA -> TAAGATAATTGAGCCCTAG
TTAAGTAGACTGCTGACAC -> TAAGTAGACTGCTGACACC
TTAATAACGGATATAAAAT -> TAATAACGGATATAAAATC
TTAATATGCAGGTGCATCG -> TAATATGCAGGTGCATCGG
TTAATTGTACGCTACGTAC -> TAATTGTACGCTACGTACG
TTACACTCATTTCTCAGAC -> TACACTCATTTCTCAGACA
TTACCAGCAGCACGTCTCA -> TACCAGCAGCACGTCTCAA
TTACCGGCAGTCACATGCT -> TACCGGCAGTCACATGCTA
TTACGCCTCGACGTATCGA -> TACGCCTCGACGTATCGAT
TTACGTAGGGAGAAAAAAA -> TACGTAGGGAGAAAAAAAT
TTACGTGCGCGAGGTAGTT -> TACGTGCGCGAGGTAGTTG
TTACTATCTGATGTTAAAA -> TACTATCTGATGTTAAAAC
TTACTGAATCGATCGATCA -> TACTGAATCGATCGATCAA
TTACTTCCCGCGTGTCAGA -> TACTTCCCGCGTGTCAGAT
TTACTTTTTGTGATGCGAG -> TACTTTTTGTGATGCGAGA
TTAGAACAATTAAGAGTAG -> TAGAACAATTAAGAGTAGT
TTAGAAGCCGGCACATCTT -> TAGAAGCCGGCACATCTTG
TTAGACTGCTGACACCACT -> TAGACTGCTGACACCACTT
TTAGAGCTTTCCCACAAAA -> TAGAGCTTTCCCACAAAAT
TTAGAGGCTGACCCTCAGT -> TAGAGGCTGACCCTCAGTT
TTAGCGGTGACACATCGGA -> TAGCGGTGACACATCGGAA
TTAGCTTCTTTTCGATTCG -> TAGCTTCTTTTCGATTCGG
TTAGGATGTCAGCTCCACT -> TAGGATGTCAGCTCCACTA
TTAGGTAGGAGCTGGTATG -> TAGGTAGGAGCTGGTATGA
TTAGTCAGTGTTGTGTCAG -> TAGTCAGTGTTGTGTCAGG
TTAGTTACTTTTTGTGATG -> TAGTTACTTTTTGTGATGC
TTATCCTTGGAGGCAAGCG -> TATCCTTGGAGGCAAGCGA
TTATCTGATTAATATGCAG -> TATCTGATTAATATGCAGG
TTATCTGATTGGTTAGCGG -> TATCTGATTGGTTAGCGGT
TTATCTGGGGCGCGAGGTC -> TATCTGGGGCGCGAGGTCA
TTATGCCGGTATGCCTAGT -> TATGCCGGTATGCCTAGTA
TTATGGCTGAGCGATTCAC -> TATGGCTGAGCGATTCACA
TTATTAGAGCTTTCCCACA -> TATTAGAGCTTTCCCACAA
TTATTTACACTCATTTCTC -> TATTTACACTCATTTCTCA
TTCAACCGAAACCAGGCTC -> TCAACCGAAACCAGGCTCT
TTCAACCTAGACTGCTGAC -> TCAACCTAGACTGCTGACA
TTCAATTTCGTGGAACGGG -> TCAATTTCGTGGAACGGGC
TTCAATTTGCCTAGTTCAC -> TCAATTTGCCTAGTTCACT
TTCACAAGCGAATTCCAAG -> TCACAAGCGAATTCCAAGT
TTCACAGCCAGTCTCCCCT -> TCACAGCCAGTCTCCCCTT
TTCACCACGAGCTCTGCAT -> TCACCACGAGCTCTGCATA
TTCACCGGCTACTCGGTTC -> TCACCGGCTACTCGGTTCG
TTCACCTACATATATAACG -> TCACCTACATATATAACGG
TTCACTGAAGACCAACAAA -> TCACTGAAGACCAACAAAA
TTCAGCTAGAATGCTACAA -> TCAGCTAGAATGCTACAAT
TTCATAAGTCGCTCCTGGT -> TCATAAGTCGCTCCTGGTA
TTCATACACGTACGCGCCG -> TCATACACGTACGCGCCGA
TTCATGCTTCACCACGAGC -> TCATGCTTCACCACGAGCT
TTCATTCGCACTTCCGAAC -> TCATTCGCACTTCCGAACA
TTCCAAAACCTACTGAATC -> TCCAAAACCTACTGAATCG
TTCCAAGTGACGACTAATT -> TCCAAGTGACGACTAATTA
TTCCAGATAGAAAGTATAT -> TCCAGATAGAAAGTATATC
TTCCCACAAAATCCCGAGG -> TCCCACAAAATCCCGAGGA
TTCCCCCTGAGGACTGGTT -> TCCCCCTGAGGACTGGTTT
TTCCCGCGTGTCAGATGGT -> TCCCGCGTGTCAGATGGTT
TTCCCTAACGTACTTAGAA -> TCCCTAACGTACTTAGAAC
TTCCGAACAATCGACCAAG -> TCCGAACAATCGACCAAGC
TTCCGCTCCAGGTACTGAA -> TCCGCTCCAGGTACTGAAT
TTCCGCTTCAATTTGCCTA -> TCCGCTTCAATTTGCCTAG
TTCCGGCACTTCCCCCTGA -> TCCGGCACTTCCCCCTGAG
TTCCTTATGGCTGAGCGAT -> TCCTTATGGCTGAGCGATT
TTCGATTCGGATATCGGGC -> TCGATTCGGATATCGGGCT
TTCGCACTTCCGAACAATC -> TCGCACTTCCGAACAATCG
TTCGCCTACCCGATCTATG -> TCGCCTACCCGATCTATGG
TTCGCGTATGACTGATTAG -> TCGCGTATGACTGATTAGA
TTCGGATATCGGGCTCGTA -> TCGGATATCGGGCTCGTAC
TTCGGCAGGAGCCATCTGA -> TCGGCAGGAGCCATCTGAT
TTCGGCTTCCAGATAGAAA -> TCGGCTTCCAGATAGAAAG
TTCGTCAGTTCCTTATGGC -> TCGTCAGTTCCTTATGGCT
TTCGTGGAACGGGCAGTCA -> TCGTGGAACGGGCAGTCAA
TTCGTTTATTAGAGCTTTC -> TCGTTTATTAGAGCTTTCC
TTCTACGCAGTTCCGGCAC -> TCTACGCAGTTCCGGCACT
TTCTAGTTTAGGTAGGAGC -> TCTAGTTTAGGTAGGAGCT
TTCTATCGCAGAATTGACC -> TCTATCGCAGAATTGACCT
TTCTCAGACACGGCTGTGC -> TCTCAGACACGGCTGTGCT
TTCTCGAGGCGGTCACTGA -> TCTCGAGGCGGTCACTGAC
TTCTTATCCTTGGAGGCAA -> TCTTATCCTTGGAGGCAAG
TTCTTCTATCGCAGAATTG -> TCTTCTATCGCAGAATTGA
TTCTTTTCAACCGAAACCA -> TCTTTTCAACCGAAACCAG
TTCTTTTCGATTCGGATAT -> TCTTTTCGATTCGGATATC
TTGAAATCTTCAGCTAGAA -> TGAAATCTTCAGCTAGAAT
TTGACCTCAACGAGAAGAG -> TGACCTCAACGAGAAGAGG
TTGACGTAACCTCCTGTAA -> TGACGTAACCTCCTGTAAG
TTGAGCCCTAGTATTTCAT -> TGAGCCCTAGTATTTCATT
TTGATAAAGATCAAAGAAC -> TGATAAAGATCAAAGAACT
TTGATCGTAAGCTCATAGA -> TGATCGTAAGCTCATAGAT
TTGCAAACTAGAGGGCCTT -> TGCAAACTAGAGGGCCTTC
TTGCAGTGTCGCTTTTTGG -> TGCAGTGTCGCTTTTTGGT
TTGCATAAAATTGCCCTGG -> TGCATAAAATTGCCCTGGG
TTGCCATGTCACATTCACC -> TGCCATGTCACATTCACCT
TTGCCCTGGGCTTCAACCT -> TGCCCTGGGCTTCAACCTA
TTGCCGCGCTTTTTTCTAG -> TGCCGCGCTTTTTTCTAGT
TTGCCGGTACATCGAATAT -> TGCCGGTACATCGAATATT
TTGCCGTTCTACGCAGTTC -> TGCCGTTCTACGCAGTTCC
TTGCCTAGTTCACTGAAGA -> TGCCTAGTTCACTGAAGAC
TTGCGCGGACGCTCAATGA -> TGCGCGGACGCTCAATGAC
TTGCTATGACTGTGAAGCA -> TGCTATGACTGTGAAGCAG
TTGGAAGACCCTTCATACA -> TGGAAGACCCTTCATACAC
TTGGAGGCAAGCGAGGGCA -> TGGAGGCAAGCGAGGGCAC
TTGGCAGTATTGCGCGGAC -> TGGCAGTATTGCGCGGACG
TTGGCCCGTGGGGCGCCAT -> TGGCCCGTGGGGCGCCATA
TTGGGTTACTGAATCGATC -> TGGGTTACTGAATCGATCG
TTGGTGAGCGTGGGCACCA -> TGGTGAGCGTGGGCACCAG
TTGGTGTTTTAGTTACTTT -> TGGTGTTTTAGTTACTTTT
TTGGTTAGCGGTGACACAT -> TGGTTAGCGGTGACACATC
TTGTACGCTACGTACGAAA -> TGTACGCTACGTACGAAAT
TTGTCTTCACCGGCTACTC -> TGTCTTCACCGGCTACTCG
TTGTGATGCGAGAACAAGA -> TGTGATGCGAGAACAAGAT
TTGTGTCAGGCGAGAGAAT -> TGTGTCAGGCGAGAGAATC
TTGTGTTGATAAAGATCAA -> TGTGTTGATAAAGATCAAA
TTGTTACCGGCAGTCACAT -> TGTTACCGGCAGTCACATG
TTTAAGATAATTGAGCCCT -> TTAAGATAATTGAGCCCTA
TTTAATAACGGATATAAAA -> TTAATAACGGATATAAAAT
TTTACACTCATTTCTCAGA -> TTACACTCATTTCTCAGAC
TTTACCAGCAGCACGTCTC -> TTACCAGCAGCACGTCTCA
TTTACGTGCGCGAGGTAGT -> TTACGTGCGCGAGGTAGTT
TTTAGACTGCTGACACCAC -> TTAGACTGCTGACACCACT
TTTAGGTAGGAGCTGGTAT -> TTAGGTAGGAGCTGGTATG
TTTAGTCAGTGTTGTGTCA -> TTAGTCAGTGTTGTGTCAG
TTTAGTTACTTTTTGTGAT -> TTAGTTACTTTTTGTGATG
TTTATGCCGGTATGCCTAG -> TTATGCCGGTATGCCTAGT
TTTATTAGAGCTTTCCCAC -> TTATTAGAGCTTTCCCACA
TTTATTTACACTCATTTCT -> TTATTTACACTCATTTCTC
TTTCAACCGAAACCAGGCT -> TTCAACCGAAACCAGGCTC
TTTCATTCGCACTTCCGAA -> TTCATTCGCACTTCCGAAC
TTTCCCACAAAATCCCGAG -> TTCCCACAAAATCCCGAGG
TTTCCCTAACGTACTTAGA -> TTCCCTAACGTACTTAGAA
TTTCGATTCGGATATCGGG -> TTCGATTCGGATATCGGGC
TTTCGTGGAACGGGCAGTC -> TTCGTGGAACGGGCAGTCA
TTTCTAGTTTAGGTAGGAG -> TTCTAGTTTAGGTAGGAGC
TTTCTCAGACACGGCTGTG -> TTCTCAGACACGGCTGTGC
TTTCTTTTCAACCGAAACC -> TTCTTTTCAACCGAAACCA
TTTGCCGCGCTTTTTTCTA -> TTGCCGCGCTTTTTTCTAG
TTTGCCTAGTTCACTGAAG -> TTGCCTAGTTCACTGAAGA
TTTGGTGAGCGTGGGCACC -> TTGGTGAGCGTGGGCACCA
TTTGTGATGCGAGAACAAG -> TTGTGATGCGAGAACAAGA
TTTTAGTTACTTTTTGTGA -> TTTAGTTACTTTTTGTGAT
TTTTATTTACACTCATTTC -> TTTATTTACACTCATTTCT
TTTTCAACCGAAACCAGGC -> TTTCAACCGAAACCAGGCT
TTTTCGATTCGGATATCGG -> TTTCGATTCGGATATCGGG
TTTTCTAGTTTAGGTAGGA -> TTTCTAGTTTAGGTAGGAG
TTTTCTTTTCAACCGAAAC -> TTTCTTTTCAACCGAAACC
TTTTGCCGCGCTTTTTTCT -> TTTGCCGCGCTTTTTTCTA
TTTTGGTGAGCGTGGGCAC -> TTTGGTGAGCGTGGGCACC
TTTTGTGATGCGAGAACAA -> TTTGTGATGCGAGAACAAG
TTTTTATTTACACTCATTT -> TTTTATTTACACTCATTTC
TTTTTCTAGTTTAGGTAGG -> TTTTCTAGTTTAGGTAGGA
TTTTTGGTGAGCGTGGGCA -> TTTTGGTGAGCGTGGGCAC
TTTTTGTGATGCGAGAACA -> TTTTGTGATGCGAGAACAA
TTTTTTCTAGTTTAGGTAG -> TTTTTCTAGTTTAGGTAGG
